------------------------
------------------------
------------------------
------------------------
---------------o--------
--------------%ooo------
--SSSS--------S-------%%
-----------------------|
----------------SSSS---|
-------------o---------|
--------SS-------------|
-----------------------|
-----------%%%%--------|
------------||---------|
XX----------||---------|
XX----------||---------|