---------DD--------D----
---------DD--------D----
---------DD--------D----
---------DD--------D----
---------DD--------D----
---------DD--------D----
---------DD--------D*---
--o------DD-------------
--D------DD--------X*---
--D-XX---DD----XX--XX*--
----XX---DD----XX--XXXXX
-*--D----------D--------
-D--D---------*D--------
-D--D*--oooo--D---------
XXX--DDDDDDDDD----------
XXX---------------------