------D------------D-D--
------D------------D-D--
------D------------D-D--
----D-D------------D-D--
----D-D------------D-D--
---DD-D------------D-D--
-D--D-D*-----------D-D--
----D--------------D-D--
----D-X*-----------D-DDD
XXXXX-XX*------k---D----
XXXXX-XXXXXXXXXXXXo-----
-----------------Xo-----
-----------------Xo-Xooo
-----------------Xo-X---
-----------------XXXXXXX
-----------------XXXXXXX