------------------------
------------------------
------------------------
------------------------
------------------------
------------D-----------
------------------------
------------------------
--------TT-------------T
--------tt-------------t
----TToott---------TToot
----ttoott---------ttoot
----ttoott---------ttoot
----ttggtt---------ttggt
XXXXXXXXXXXXXXXXXXXXXXXX
XXXXXXXXXXXXXXXXXXXXXXXX