---D--------------------
---D--------------------
---D--------------------
---D--------------------
---D--------------------
---D-----o--------------
---D----o-o-------------
---D---o-o-o--D---------
DD-DDDDDDDDDDDDo--------
D--------------oD-------
*-X------------oD-------
--X*-----------DD-------
*XX*------------X---#---
-XX---y-----y---XX--#--y
XXXXXXXXXXXXXXXXXXXXXXXX
XXXXXXXXXXXXXXXXXXXXXXXX