------------------------
------------------------
------------------------
------------------------
------------------------
------------------------
------------------------
----------------o-------
----------------D-------
-X--------------D-------
XX--o------------------T
-X--o----------*-------t
-X--o-------*--D-------t
X-------k---D--D-------t
XXXXXXXXXXXXXXXXXXXXXXXX
XXXXXXXXXXXXXXXXXXXXXXXX