------------------------
------------------------
------------------------
------------------------
------------------------
---------D------------DD
--------------------TTDD
--------------------tt--
-----TT-------g-g---tt--
-----tt---XXXXXXXTTXXXXX
-TToott---XXXXXXXttXXXXX
-ttoott----------tt-----
-ttoott----------tt-----
-ttggtt----------tt-----
XXXXXXXXXX-------tt-----
XXXXXXXXXX-------tt-----