----------------D-------
----------------D-------
----------------D-------
----------------D-------
----------------D-------
----------------D-------
----------------D------o
----------------D-----o-
----------------D----o-o
-------o--------DDDDDDDD
-------o----------------
----o--o--o-------------
---o-------o---------TT-
-------r-------------tt-
X------X-----TT--TT--tt-
X------X-----ttX-tt--tt-