------------------------
------------------------
---#------------YYY-----
---#------------DDD-----
------------------D-----
#-----------------D-----
#---------------D-D-----
#---------------o-D-----
---#----ooo-----o-D----o
---#-DD-DDDD-DDDDDD----#
---#------------------##
--##-----------------###
-###---------------o-###
-###---------------#-###
XXXX---------------X-XXX
XXXX---------------X-XXX