-----D------------D-D---
-----D------------D-D---
-----D------------D-D---
-----D------------D-D---
--YD-D------------D-D---
-TTD-D------------D-D---
-ttD-D------------D-D---
-ttD-D------------D-D---
DttD-D------------D-D---
-tt--D------------D-DDDD
-tt--DDDDDDDDDDDDD------
-tt-------oo------------
-tt---------------------
-tt--k--y----y----------
-tt-XXXXXXXXXXXXXXX--TT-
-tt-XXXXXXXXXXXXXXXX-tt-