--D-D-------------------
--D-D-------------------
--D-D-------------------
--D-D-------------------
--D-D-------------------
--D-D-------------------
--D-D------o------------
--D-D-----o-o-----------
--D-D----o-o-o----------
--D-DDDDDDDDDDDDD-------
DD----------------------
----------------------DD
---------TT----------D--
---------tt---------D---
XXX--TT--tt---TT--XXXXXX
XXXX-tt--tt---tt--XXXXXX