--------------------D---
--------------------D---
--------------------D---
--------------------D---
--------------------D---
--------------------D---
------------------D-D---
---o-------------YD-D---
---D-------------DD-D---
---D--------------D-D---
------------g-g-g-D-DDDD
--*-----DDDDDDDDDDD-----
--D----D----------D-----
--D---D-----------D-k--y
XXXXXXXXXXXXXXXXXXXXXXXX
XXXXXXXXXXXXXXXXXXXXXXXX