------------------------
------------------------
------------------------
------------------------
------------------------
------------------------
----------------D-------
---------------YD-------
---------------DD----ooo
-X--------------D##--###
XX--------g-g-g-D-#-y#--
-X----DDDDDDDDDDD--##---
-X---D----------D-------
X---D-----------D-------
XXXXXXXXXXXXXXXXX-------
XXXXXXXXXXXXXXXXX-------