------------------------
------------------------
-YYY--------------------
-DDD--------------------
---D--------------------
---D--------------------
-D-D--------------------
-o-D-D----y---y---Y-----
-o-D-DDTTDDDTTDDTTD-----
DDDD---tt---tt--tt------
-------tt---tt--tt------
-------tt---tt--tt-----D
-------tt---tt--tt----D-
-------tt---tt--tt---D--
-------tt---tt--tt-XXXXX
-------tt---tt--tt-XXXXX