------------------------
------------------------
--------------------YYY-
--------------------DDD-
----------------------D-
----------------------D-
--------------------D-D-
-----D--------------o-D-
------------ooo-----o-D-
DDDDDD---DD-DDDD-DDDDDD-
---D---X----------------
---D---X----------------
-----o-X----------------
-----*-X----------------
XXXXXXXX----------------
XXXXXXXX----------------