------------------------
------------------------
------------------------
---------D--------------
--------DD--------------
-----oo--D--------------
-----TT--D--------------
-----tt--D--------------
oo-------D--------------
TT-------D--------o-----
tt---oo--D--------o-----
-----TT--D-----o--o--o--
-----tt--D----o-------o-
-g---tt--D--------r-----
XX-X--XX-XXX------X-----
XX-X--XX-XXX------X-----