------------------------
------------------------
------------------------
------------------------
------------------------
------------------------
------------------------
------------------------
------------------------
------------------------
--TT-------TT-----------
--TT-----TTTT----TT-----
--TT---TTTTTT----TT-----
--TT---TTTTTT----TT-----
XXXXXXXXXXXXXXXXXXXXXXXX
XXXXXXXXXXXXXXXXXXXXXXXX