------------------------
------------------------
------------------------
------------------------
------------------------
------------K-----------
--------SSSSSS----1-----
------------------------
------------------------
---------K--------------
-------SSSSSSS----------
-TT---------------TT----
-TT---------------TT----
-TT---------------TT----
XXXXXXXXXXXXXXXXXXXXXXXX
XXXXXXXXXXXXXXXXXXXXXXXX