-----------------------
-----------------------
-----------------------
-----------------------
-----------------------
-----------------------
---------SSSSS---------
-----------------------
-----------------------
----------K------------
---------SSSSS---------
------------K---#----*-
---TT-----------#----*-
---TT-----------#----*-
XXXXXXXXXXXXXXXXXXXXXXX
XXXXXXXXXXXXXXXXXXXXXXX