-----------------------
-----------------------
-----------------------
-----------------------
-----------------------
-----------------------
-----------------------
-----------------------
---------------------#-
--------------------##-
-------------------###-
------------------####-
-----------------#####-
-----ggg------gg######-
XXXXXXXXXXXXXXXXXXXXXXX
XXXXXXXXXXXXXXXXXXXXXXX