------------------------
------------------------
------------------------
------------------------
------------------------
------------------------
------------------------
------------------------
------------------------
------------------------
------------------------
-----------------------#
----------------------##
--ggg-----ggg------gg###
XXXXXXXXXXXXXXXXXXXXXXXX
XXXXXXXXXXXXXXXXXXXXXXXX