------------------------
------------------------
------------------------
------------------------
------------------------
------------------------
--------------------##--
--------------------##--
------------------#-##--
------------------#-##--
----------------#-#-##--
----------------#-#-##--
---------TT---#-#-#-##--
---------TT---#-#-#-##--
XXXXXXXXXXXXX-X-X-X-XXXX
XXXXXXXXXXXXX-X-X-X-XXXX