-----------------------
-----------------------
-----------------------
-----------------------
-----------------------
-----------------------
-----------------------
-----------------------
-----------------------
----------oo---oo------
-----------------------
-----------------------
-#---------------------
-#---------------------
XXXXXXXX-----X----XXXXX
XXXXXXXX-----X----XXXXX