-----------------------
-----------------------
-----------------------
-----------------------
-----------------------
-----------------------
-----------------------
-----------------------
-------------------*---
-------------------*---
-----------------SS#CS-
-*-----K---*-----------
-*---------*-----------
-*---------B-----------
XXXXXXXXXXXXXXXXXXXXXXX
XXXXXXXXXXXXXXXXXXXXXXX