-----------------------
-----------------------
-----------------------
-----------------------
-----------------------
-----------------------
-----------------------
-----------------------
-----------------------
-----------------------
-----------------------
---------------#-------
----------*----#-------
---ggg----*----#----ggg
XXXXXXXXXXXXX--XXXXXXXX
XXXXXXXXXXXXX--XXXXXXXX