-----------------------
-----------------------
-----------------------
-----------------------
-----------------------
-----------------------
---------------------LS
-----------------------
-----------------g-----
-----------------#-----
--------SUS-----##---2-
---------------###-----
--------------####-----
--M----------#####----k
XXXXXXXXXXXXXXXXXXXXXXX
XXXXXXXXXXXXXXXXXXXXXXX