-----------------------
-----------------------
-----------------------
-----------------------
-----------------------
-----------------------
-----------------------
---------------------TT
---------------------TT
---------------------TT
------------tt------SXX
----TT------tt---------
----TT------tt-TT------
--k-TT------tt-TT------
XXXXXXXXXXXXXXXXXXXXXXX
XXXXXXXXXXXXXXXXXXXXXXX