-----------------------
-----------------------
-----------------------
-----------------------
-----------------------
------------k----------
-----------##----------
----------###----------
--------k####----------
--------#####----------
-------######----------
------#######----------
-----########--------F-
----#########--------#-
XXXXXXXXXXXXXXXXXXXXXXX
XXXXXXXXXXXXXXXXXXXXXXX