-----------------------
-----------------------
-----------------------
-----------------------
-----------------------
-----------------------
--------------------##-
--------------------##-
------------------#-##-
------------------#-##-
----------------#-#-##-
----------------#-#-##-
---------TT---#-#-#-##-
---------TT---#-#-#-##-
XXXXXXXXXXXXX-X-X-X-XXX
XXXXXXXXXXXXX-X-X-X-XXX