-----------------------
-----------------------
-----------------------
-----------------------
-----------------------
-----------------------
-SSSS------------------
-----------------------
-----------------------
------------g----------
------------TT---------
------------TT---------
------------TT---------
------------TT---------
X----XXXXXXXXXX---XXXXX
X----XXXXXXXXXX---XXXXX