-----------------------
-----------------------
-----------------------
-----------------------
-----------------------
-----------------------
-----------------------
-----------------------
-----------------------
o------o----o----------
-----------------------
-----------------------
-------------------#---
-------------------#-k-
XXXXXX---XX---XXXXXXXXX
XXXXXX---XX---XXXXXXXXX