-----------------------
-----------------------
-----------------------
-----------------------
-----------------------
-----------------------
---------------------##
---------------------##
------------------y--##
------------------#--##
-----------------##--##
---------------y###--##
---------------####--##
--------------#####--##
XXXXXXXXX---XXXXXXX--XX
XXXXXXXXX---XXXXXXX--XX