------------------------
------------------------
------------------------
------------------------
------------------------
------------------------
----------------------SS
------------------------
------------------------
------------------------
---------------------#--
--------TT-----------#--
--------TT-----------#--
--------TT------ggg--#--
XXXXXXXXXXXXXXXXXXXXXXXX
XXXXXXXXXXXXXXXXXXXXXXXX