--------------D-D-------
--------------D-D-------
--------------D-D-------
--------------D-D-------
--------------D-D-------
--------------D-D-------
--------------D-D------o
--------------D-D-----o-
--------------D-D----o-o
DD---oooooo---D-DDDDDDDD
-----TTTTTT---D---------
-----tttttt-------------
-----tttttt-D--------TT-
-----tttttt-D--------tt-
-----tttttt-DTT--TT--tt-
-----tttttt-XttX-tt--tt-