----------D----D--------
----------D----D--------
----------D----D--------
----------D----D--------
----------Do--oD--------
----------Do--oD--------
------------------------
---o--------------------
---2X---#y-#--#y-#------
----X#--####--####-----g
---oX------------------#
---2X----------------g##
----X----------------###
----X---------------####
X-XXX---------------XXXX
X-XXX---------------XXXX