-------------D---------D
-------------D---------D
-------------D---------D
-------------D---------D
-------------D---------D
-------------D---------D
----------D--D---------D
---------YD--D---------D
---------DD--D---------D
----------D--DDDDDDDDDDD
----g-g-g-D-------------
DDDDDDDDDDD-------------
----------D------ooo---o
----------D-------y--Y--
XXXXXXXXXXXXXXXXXXXXXXXX
XXXXXXXXXXXXXXXXXXXXXXXX