-----------D------------
-----------D------------
-----------D------------
-----------D------------
-----------D------------
-----------D------------
---------D-D------------
--------YD-D------------
--------DD-DDDDDDDDDDD--
---------D-----------D--
---g-g-g-D-----------D--
DDDDDDDDDD-------------o
---------D-------------o
---------D---XyX-XyXyX-o
XXXXXXXXXXX--XXX-XXXXX-X
XXXXXXXXXXX--XXX-XXXXX-X