------------DD----------
-------------D----------
-------------D----------
-------------D----------
-------------D----------
-------------D----------
-----------D-D----------
----------YD-D----------
----------DD-D----------
-----------D-DDDDDDDDDDD
-----g-g-g-D----------D-
-DDDDDDDDDDD-o--------D-
D----------D-*----------
-----------D-D----r-----
XXXXXXXXXXXXXXXXXXXXXXXX
XXXXXXXXXXXXXXXXXXXXXXXX