-----------D------------
-----------D------------
-----------D------------
-----------D------------
-----------D------------
-----------D-----o------
---------D-D----o-o-----
--------YD-D---o-o-o--D-
--------DD-DDDDDDDDDDDDo
---------D-------------o
---g-g-g-DX------------o
DDDDDDDDDDX*-----------D
---------DX*------------
---------DX---y-----y---
XXXXXXXXXXXXXXXXXXXXXXXX
XXXXXXXXXXXXXXXXXXXXXXXX