------------------------
------------------------
------------------------
------------------------
------------------------
------------------------
------------------------
------------------------
------D-----------------
-SSS@SSSS---D-----------
--------S---D---o-------
---------SSSD---o-------
-oo-------ooD---o-------
-oo--g----ooD------g--g-
XXXXXXXXXXXXXXXXXXXXXXXX
XXXXXXXXXXXXXXXXXXXXXXXX