------------------------
------------------------
!--!--------------------
------------------------
------------------------
!--!--------------------
------------------------
-----k------------------
XXXXXX------------------
XXXXXX---------------X--
-------------TT-----XX--
------------otto-----X--
------------otto-----X--
-------X-X--otto--X-X-X-
-------XXXXXXXXXXXXXXXXX
-------XXXXXXXXXXXXXXXXX