---------X--------------
---------X--------------
---------X--------------
---------X--------------
-g-X------X-------------
DD-XX---XXXX----X-------
D--XX---XXXXX--XX-------
---XX---XXXXX---X---k---
---XX--oXXXXX---X-%%%%%%
XX-XX--oXXXXXX--X-%%%%%%
XX-XX---o-------X-------
---XX---o-------X-------
---XX---XXX-XXXXX-------
---XX----XX-XXXXX-------
---XX----XX-XXXXX-------
---XX----XX-XXXXX-------