--------------------DD--
--------------------DD--
-----------YYY------DD--
-----------DDD------DD--
-------------D------DD--
-------------D------DD--
-----------D-D------DD--
-----------o-D------DD--
---ooo-----o-D------DD--
DD-DDDD-DDDDDD-XX---DD--
---------------XX---DD--
---------------D--------
---------------D--------
---------------D*--oooo-
----------------DDDDDDDD
------------------------