----------DD-------DD---
----------DD--------D---
----------DD--------D---
----------DD--------D---
----------DD--------D---
----------DD--------D---
---o------DD--------D---
---o------DD--------D---
---o------DD--------D---
---D-XX---DD----XX--DDDD
-----XX---DD----XX------
--*--D----------D---o---
--D--D---------*D---*---
--D--D*--oooo--D----D---
XXXX--DDDDDDDDD----XXXXX
XXXX---------------XXXXX