-----DDD--------------D-
-----D-D--------------D-
-----D-D--------------D-
-----D-D--------------D-
-----D-D--------------D-
-----D-D--------------D-
-----D-D--------------D-
-----D-D----------D---D-
-----D-D--------------D-
-k---D-DDDDDDDDDDDD---DD
XXXXo-----------D---X---
---Xo--o--------D---X---
---Xo--*----------o-X---
---Xo--D----r-----*-X---
---XXXXXXXXXXXXXXXXXX--T
---XXXXXXXXXXXXXXXXXXX-t