------------------------
------------------------
------------------------
--------------------o---
-------------------o----
------------------o-----
------------------#-----
-----------------##-----
-----------------##-----
----------X---o--##-----
--TT-----XX---#--##-----
-otto-----X--##--##-----
-otto-----X--##--##-----
-otto--X-X-#-##--##----#
XXXXXXXXXXXX-XX--XXXXXXX
XXXXXXXXXXXX-XX--XXXXXXX