------------------------
------------------------
------------------------
------------------------
------------------------
-----------------------o
-----------------------#
----------------------##
----------------------##
-------------------o--##
-------------------#--##
--------C-S-S-C---##--##
------------------##--##
--------ooo-----#-##--##
XXXXX--XXXXX-XXXX-XX--XX
XXXXX--XXXXX-XXXX-XX--XX