------------------------
------------------------
-----------YYY----------
-----------DDD----------
-------------D----------
-------------D-------o--
-----------D-D-------#--
-----------o-D------##--
---ooo-----o-D----o-##--
DD-DDDD-DDDDDD----#-##--
-----------------##-##--
----------------###-##--
--------------o-###-##--
--------------#-###-##g-
--------------X-XXX-XXXX
--------------X-XXX-XXXX