-D----------------------
-D----------------------
-D----------------------
-D----------------------
-D----------------------
-D----------------------
-D------o---------------
-D-----o-o--------------
-D----o-o-o-------------
-DDDDDDDDDDDDD---------o
-----------------------o
-----------------------o
------TT---------------o
------tt---------------o
--TT--tt---TT--X-------X
X-tt--tt---tt--X-------X