---------------------D--
---------------------D--
---------------------D--
---------------------D--
---------------------D--
---------------------D--
------------------D--D--
---o-------------YD--D--
---D-------------DD--D--
---D--------------D--DDD
------------g-g-g-D-----
--*-----DDDDDDDDDDD-----
--D----D----------D-----
--D---D-----------D-----
XXXXXXXXXXXXXXXXXXXXXXXX
XXXXXXXXXXXXXXXXXXXXXXXX