--D----D----------------
--D----D----------------
--D----D----------------
--D----D-----------o--o-
--Do--oD----------------
--Do--oD----------------
-------------------#----
-----------------g##----
#y-#--#y-#-------###----
####--####-----g####----
---------------#####----
-------------g######----
-------------#######----
------------########----
------------XXXXXXXXXXXX
------------XXXXXXXXXXXX