-----D------------D-----
-----D------------D-----
---#-D------------D-----
---#-D------------D-----
-----D------------D-----
#----D------------D-----
#----D------------D-----
#----D------------D-----
---#-D------------D-----
---#-D------------D-----
---#-DDDDDDDDDDDDD------
--##------oo------------
-###------------------#-
-###-k--y----y-----X--#-
XXXXXXXXXXXXXXXXXXXXXXXX
XXXXXXXXXXXXXXXXXXXXXXXX