------------------------
------------------------
------------------------
------------------------
------------------------
------------------------
---------------------D--
--------------------YD--
--------------------DD--
XXXXXX---------------DXX
XXXXXX---------g-g-g-DXX
-----------DDDDDDDDDDD--
----------D----------D--
---------D-----------D--
-------XXXXXXXXXXXXXXX--
-------XXXXXXXXXXXXXXX--