------------------------
------------------------
---#--------------------
---#--------------------
------------------------
#-----------------------
#-----------------D-----
#----------------YD-----
---#-------------DD-----
---#--------------D--SSS
---#--------g-g-g-D-----
--##----DDDDDDDDDDD-----
-###---D----------D--oo-
-###--D-----------D--oo-
XXXXXXXXXXXXXXXXXXXXXXXX
XXXXXXXXXXXXXXXXXXXXXXXX