---------------------D--
---------------------D--
---------------------D--
---------------------D--
---------------------D--
----X----------------D--
----X----------------D--
---XX----------------D--
X-XXX----oooo-----g--D--
X-XXX##--####--#####-D--
---oX-#-y#--#-y#-----DDD
---oX--##----##---------
---oX-------------------
---oX----------------k--
X-XXX---------------XXXX
X-XXX---------------XXXX