------------------------
------------------------
------------------------
------------------------
------------------------
--------X--------------D
--------X---------------
-------XX---------------
XXXXX-XXX----------TT---
XXXXX-XXX----------tt---
-------oX------TToott---
-------oX------ttoott---
-------oX------ttoott---
--g----oX------ttggtt---
XXXXX-XXXXXXXXXXXXXXXXXX
XXXXX-XXXXXXXXXXXXXXXXXX