------------------------
------------------------
------------------------
------------------------
------------------------
--------X---------------
--------X-----o---------
-------XX----Xo---------
XXXXX-XXX----Xo---------
XXXXX-XXX-XXXXXTTXXXXXX-
-------oX-XXXXXttXXXXXX-
-------oX------tt-------
-------oX------tt-------
--g----oX------tt-------
XXXXX-XXX------tt-------
XXXXX-XXX------tt-------