------------------------
------------------------
------------------------
------------------------
----------oo------------
----X------------oX-----
----X------------oX-----
---XX------------XX-----
X-XXX-XXX----XX--XX-----
X-XXX-XXX----XX--XX-----
---oX---X---------X-----
---oXX--X---------X-----
---oXX--X---------X-----
---oX---X---------X-----
X-XXXXXXX---------X-XXXX
X-XXXXXXX---------X-XXXX