----------------D-------
----------------D-------
----------------D-------
----------------D-------
----------------D-------
----------------D-------
----------------D-------
------------o---D-------
X-----------2X--D-------
X------------X--DDDDDDDD
X-----------oX----------
X-----------2X----------
X------------X------ooo-
X-r-----r----X-------y--
XXX--XX-XX-XXXXXXXXXXXXX
XXX--XX-XX-XXXXXXXXXXXXX