----------D------------D
----------D------------D
----------D------------D
----------D------------D
----------D------------D
--------X-D------------D
--------X-D------------D
-------XX-D------------D
XXXXX-XXX-D------------D
XXXXX-XXX-D------------D
-------oX-DDDDDDDDDDDDD-
-------oX------oo-------
-------oX---------------
--g----oX-k--y----y-----
XXXXX-XXXXXXXXXXXXXXXXXX
XXXXX-XXXXXXXXXXXXXXXXXX