------------------------
------------------------
------------------------
------------------------
-------------oo---------
-------X------------oX--
-------X------------oX--
------XX------------XX--
XXXX-XXX-XXX----XX--XX--
XXXX-XXX-XXX----XX--XX--
------oX---X---------X--
------oXX--X---------X--
------oXX--X---------X--
-g----oX---X---------X--
XXXX-XXXXXXX---------X-X
XXXX-XXXXXXX---------X-X