------------------------
------------------------
!--!-----------------#--
---------------------#--
------------------------
!--!--------------#-----
------------------#-----
------------------#-----
oXXoXX---------------#--
XXXXXX---------------#--
XXXX-----------------#--
X-------------oo----##--
----------#---##---###--
-------X--#--y--y--###--
-------XXXXXXXXXXXXXXXXX
-------XXXXXXXXXXXXXXXXX