------------------------
------------------------
------------------------
------------------------
------------------------
------------------------
--o---------------------
-Xo---------------------
-Xo-------------------TT
XXXTTXXXXXX-----------tt
XXXttXXXXXX-------TToott
---tt-------------ttoott
---tt-------------ttoott
---tt-------------ttggtt
---tt-------XXXXXXXXXXXX
---tt-------XXXXXXXXXXXX