D---------------------DD
D---------------------DD
D--------------#------DD
D--------------#------DD
D---------------------DD
D-----------#---------DD
D-----------#---------DD
D-----------#---------DD
D--------------#------DD
D--------------#-XX---DD
---------------#-XX---DD
--------oo----##-D------
----#---##---###-D------
-X--#--y--y--###-D*--ooo
XXXXXXXXXXXXXXXX--DDDDDD
XXXXXXXXXXXXXXXX--------