------------------------
------------------------
------------------------
------------------------
------------------------
------------------------
-------------D----------
------------YD----------
------------DD----g-g---
-------------DXXXXXXXTTX
-------g-g-g-DXXXXXXXttX
---DDDDDDDDDDD-------tt-
--D----------D-------tt-
-D-----------D-------tt-
XXXXXXXXXXXXXX-------tt-
XXXXXXXXXXXXXX-------tt-