------------------------
------------------------
------------------------
------------------------
------------------------
---------------------D--
------------------------
------------------------
-----g-----------TT-----
--#####----------tt----D
-y#----------TToott-----
##-----------ttoott-----
-------------ttoott-----
-------------ttggtt-----
-------XXXXXXXXXXXXXXX--
-------XXXXXXXXXXXXXXX--