----D-------------------
----D-------------------
----D-------------------
---oD-------------------
---oD-------------------
--y--------------------D
####--------------------
------------------------
---#g-g------------TT---
---######----------tt---
---------------TToott---
---------------ttoott---
---------------ttoott---
---------------ttggtt---
---------XXXXXXXXXXXXXXX
---------XXXXXXXXXXXXXXX