------------------------
------------------------
---------------#--------
---------------#---#----
-----------------###----
------------#--------#--
------------#--------###
------------#-----------
---------------#--------
---------------#--------
---------------#--------
--------oo----##--------
----#---##---###--------
-X--#--y--y--###--------
XXXXXXXXXXXXXXXX--------
XXXXXXXXXXXXXXXX--------