------------------------
------------------------
------------------------
------------------------
------------------------
--D--------------D------
------------------------
------------------------
-------------TT-------oo
-------------tt----DD-DD
---------TToott---------
---------ttoott---------
---------ttoott---------
---------ttggtt---------
XXXXXXXXXXXXXXXXXX------
XXXXXXXXXXXXXXXXXX------