------------------------
------------------------
------------------------
------------------------
------------------------
------------------------
------------------------
---------o--------------
---------D--------------
---------D--------------
------------o-----------
--------*---o----------*
-----*--D---o-------*--D
-k---D--D------g--g-D--D
XXXXXXXXXXXXXXXXXXXXXXXX
XXXXXXXXXXXXXXXXXXXXXXXX