----D-------------------
----D-------------------
----D-------------------
----D-------------------
----D-------------------
----D-------------------
----D--------------D----
----D-------------YD----
----D-------------DD---#
----D--------------D#--#
DDDD---------g-g-g-D----
---------DDDDDDDDDDD----
--------D----------D----
-------D-----------D----
XXXXXXXXXXXXXXXXXXXX----
XXXXXXXXXXXXXXXXXXXX----