------------------------
------------------------
------------------------
------------------------
------------------------
----------D-------------
------------------------
------------------------
------TT----------------
------tt----------------
--TToott-----o----------
--ttoott-----o----------
--ttoott-----o-------*--
--ttggtt--------g--g-D--
XXXXXXXXXXXXXXXXXXXXXXXX
XXXXXXXXXXXXXXXXXXXXXXXX