-------------------D----
-------------------D----
-------------------D----
-------------------D----
-------------------D----
-------------------D----
--------o----------D----
--D----Xo----------D----
-------Xo----------D----
D---XXXXXTTXXXXXX--DDDDD
----XXXXXttXXXXXX-------
--D------tt-------------
--D------tt-------------
--D------tt-------------
XXX------tt---------TT--
XXX------tt-------X-tt--