------------------------
------------------------
------------------------
------------------------
------------------------
------------------------
------------D-----o-----
-----------YD----Xo-----
-----------DD----Xo-----
------------D-XXXXXTTXXX
------g-g-g-D-XXXXXttXXX
--DDDDDDDDDDD------tt---
-D----------D------tt---
D-----------D------tt---
XXXXXXXXXXXXX------tt---
XXXXXXXXXXXXX------tt---