----------------DD------
-----------------D------
-----------------D------
-----------------D------
------oo---------D------
-------------oX--D------
-------------oX--D------
o------------XX--D------
D-XXX----XX--XX--D------
D-XXX----XX--XX--DDDDDDD
----X---------X---------
-X--X---------X--o------
-X--X---------X--*------
----X---------X--D----r-
XXXXX---------X-XXXXXXXX
XXXXX---------X-XXXXXXXX