D------------D----------
D------------D----------
D------------D----------
D------------D----------
D------------D----------
D------------D-------o--
D------------D-------#--
D------------D------##--
D------------D----o-##--
D----oo-----oD----#-##--
D-----------*D---##-##--
Do---TT---------###-##--
D*---tt--oo---o-###-##--
-----tt-------#-###-##g-
XXX--tt--TT-XXX-XXX-XXXX
-----tt--tt---X-XXX-XXXX