-----------------------D
-----------------------D
-----------------------D
-----------------------D
-----------------------D
-----------------------D
---------------------D-D
--------------------YD-D
--------------------DD-D
---------------------D--
o--------------g-g-g-D--
-o--K------DDDDDDDDDDD--
D---D-----D----------D--
--D------D-----------D--
XXXXXXXXXXXXXXXXXXXXXXX-
XXXXXXXXXXXXXXXXXXXXXXX-