------------------------
------------------------
------------------------
------------------------
------------------------
------------------------
------------------------
------------------------
-------------------TT---
-------------TT----TT---
---TT---SU---TT----XX---
K--TT--------TT---------
---TT--------TT---------
---TT------k-TT---------
XXXXXXXXXXXXXXXXXXXXXXXX
XXXXXXXXXXXXXXXXXXXXXXXX