------------------------
------------------------
------------------------
---------D--------------
--------DD--------------
-----oo--D--------------
-----TT--D--------------
-----tt--D--------------
oo-------D--------------
TT-------D---------o----
tt---oo--D---------o----
-----TT--D---------o----
-----tt--D---------o----
-g---tt--D---------o----
XX-X--XX-XXX-------X----
XX-X--XX-XXX-------X----