--D----------------D----
--D----------------D----
--D----------------D----
--D----------------D----
--D----------------D----
--D----------------D----
--D----------------D*---
--D---------------------
--D----------------X*---
--D--------------X-XX*--
--D------TT-----XX-XXXXX
--------otto-----X------
D-------otto-----X------
D--X-X--otto--X-X-------
DTTXXXXXXXXXXXXXXX------
XttXXXXXXXXXXXXXXX------