----------DD--------D---
----------DD--------D---
----------DD--------D---
----------DD--------D---
----------DD--------D---
----------DD--------D---
----------DD--------D*--
---o------DD------------
---D------DD--------X*--
---D-XX---DD----XX--XX*-
-----XX---DD----XX--XXXX
--*--D----------D-------
--D--D---------*D-------
--D--D*--oooo--D--------
XXXX--DDDDDDDDD---------
XXXX--------------------