-------------X----------
-------------X----------
-------------X----------
-------------X----------
-----g-X------X---------
---DDD-XX---XXXX----X---
-TTDD--XX---XXXXX--XX---
-tt----XX---XXXXX---X---
-tt----XX--oXXXXX---X-%%
XXXXXX-XX--oXXXXXX--X-%%
XXXXXX-XX---o-------X---
-------XX---o-------X---
-------XX---XXX-XXXXX---
-------XX----XX-XXXXX---
-------XX----XX-XXXXX---
-------XX----XX-XXXXX---