---------------D--------
---------------D--------
---------------D--------
---------------D--------
---------------D--------
---------------D--------
-------------D-D--------
------------YD-D--------
------------DD-D--------
-------------D-D--------
-------g-g-g-D-DDDDDDDDD
---DDDDDDDDDDD------oo--
--D----------D----------
-D-----------D-k--y----y
XXXXXXXXXXXXXXXXXXXXXXXX
XXXXXXXXXXXXXXXXXXXXXXXX