-----------------D------
-----------------D------
-----------------D------
-----------------D------
-----------------D------
X----------------D------
X--------------D-D------
X-------------YD-D------
X-------------DD-D------
X--------------D-D------
X--------g-g-g-D-DDDDDDD
X----DDDDDDDDDDD------oo
X---D----------D--------
X--D-----------D-k--y---
XXXXXXXXXXXXXXXXXXXXXXXX
XXXXXXXXXXXXXXXXXXXXXXXX