------------------------
------------------------
------------------------
------------------------
------------------------
----------ooooo---------
SSS-----SSS------SS-----
------------------------
------------S-----------
------------------------
-----------------SS-----
------------------------
--------|---------------
--------|---------------
-------%%%%----------%%%
--------||------------||