------------------------
------------------------
------------------------
-----------------oo-----
------------------------
---ooooo----------------
-SSS------SS-----SSS----
------------------------
-----S-----------------S
------------------------
----------SS------------
------------------------
-|----------------------
-|----------------------
%%%%----------%%%%%%----
-||------------|||------