------------------------
------------------------
---------------%--------
-------oo------|--------
--------------%|%-------
---------------|--------
SS-----SSS-----|--%-----
---------------|-|------
-------------S-|||------
---------------|||------
SS-------------|||--%%--
-----------------|---|%%
-----------------|---|||
-----------------|---|||
----%%%%%%-------|---|||
-----|||---------|---|||