------------------------
------------------------
------------------------
------------------------
------------------------
------------------------
-----SSSoo--o----------S
------------------------
---SSS-------%----------
------------------------
---------SSS-|%%%%----%%
-------------||||------|
-------------||||------|
-------------||||------|
%------------|||||%%%-%%
-------------||-||||---|