------------------------
------------------------
------------------------
------------------------
------------------------
------------------SSo---
---SS-------SS----------
------------------------
--------------------SSSS
------------------------
%-------------%%%%------
---------------||-------
---------------||-------
--------------|||-------
---%%%XXX--%%%%||-%%%---
----||--X---|||||-------