------------------------
------------------------
------------------------
----------------------oo
------------------------
------------------------
---SSSSoo------------%%%
----------------------|-
----------------------|-
ooo--------oooo-------|-
-------SSSS%%%------S%%%
-----------||---------||
-----------||---------||
-----------||---------||
%%%%%------||---------||
||||--------|---------||