------------------------
------------------------
------------------------
------------------------
------------------------
------------------------
SSS-----%%%%%-----------
-----------|------------
----------||---S-------o
-----S-----|---S--------
-----------|---S---S%%%-
-----------|---SS----|--
-----------|---------|--
-----------|---------|--
-----------|---------|--
-----------|---------|--