------------------------
------------------------
------------------------
------------------------
------------------------
------------------------
------------------------
-------ooooo------------
o-----------------------
--o---------------------
%%%-----%%%%-%%--------S
-|-------||----------SS-
-|-------||-%%%---------
-|-------||--||---------
-|---%%%%%%-|||---------
-|----||%|---||---------