------------------------
------------------------
------------------------
------------------------
------------------------
------------------------
----------------------SS
------------------------
-----------SSS----------
------------------------
-%%%%%%%S---------SSS---
--||||--------SS--------
%-||||------------------
|-||||------------------
|-||||----------------%%
|-||||-----------------|