------------------------
------------------------
--------------%%--------
--------------||--------
--------------||--------
--------------||--------
------------o-||%%%-----
------------S-||-|------
-------SSS----||-|------
-----------------|------
%%%%%%--------S-||------
-|%%|-----------||---%%%
-||||-----------||%%%-||
-||||-----------||-||-||
|||||-----------|||||-||
|||||-----------|-|||-||