------------------------
------------------------
------------------------
------------------------
------------------------
------------------------
--SSS-------------------
------------------------
-------SS--------SSS----
------------------------
--------%%%%------------
---------||-------------
---------||-------------
---------||-------------
%%%%%%----|-%----%%%%%%%
||||------||------||-||-