------------------------
------------------------
------------------------
------------------------
-----------------------o
------------------ooooo-
-----SS---------SSS-----
------------------------
------|--------------SS-
------|-----------------
%%%S--%%%%%%------------
||-----||||-------------
||-----|||--------------
||-----||||-------------
||----%||||%%%%%%%%%----
||-----||||-|||||||-----