------------------------
------------------------
------------------------
------------------------
------------------------
------------------------
------------------------
-----------------------o
--SSS-------SSooo-------
---------oo-------o-----
--------SS------%%%-----
-----------------|------
-----------------|------
-----------------|------
XXXXX------------|---%%%
XXXXX------------|----||