------------------------
------------------------
------------------------
------------------------
------------------------
------------------------
----------------SS------
----------------------||
----------------------||
----------------------||
%%%%------%%%---------||
-||----%%%%|----------||
-|------||||----------||
||------||||----------||
||-%%%%%|||||------%%-||
||--|||-||||-------||-||