------------------------
------------------------
------------------------
------------------------
-------------o-S%%%%----
-----------oo-----|-----
S-------SSSS------|-----
------------------|-----
--S-----------SS--|-----
------------------|-----
------------------%%%%%-
--------------------||--
--------------------||--
--------------------||--
------%%%-----%----|||--
-------|%----------|||--