------------------------
------------------------
------------------------
------------------------
------------------------
------------------------
-----------SS%%%%-------
--------------||--------
---S----------||--------
--------------||--------
-----%%%%-----||------%%
------||------||-------|
---|--||------||-------|
---|--||------||-------|
%--|--||------|||%%%%--|
---|--||-------|||||---|