------------------------
------------------------
------------------------
------------------------
------------------------
------------------------
SS------------------SSSS
----------ooo-----------
------SS----------------
------------------------
--%------SS%%%%%%%%%%--%
--%%%%-------|||||||----
--|||-------||||||||----
--|||-------||||||||----
%-|||-------|||-||||----
|-|||-------||--||||----