------------------------
------------------------
------------------------
------------------------
------------------------
---------o--------------
----SS-----------------S
------------------------
---------------S--------
------------------------
%%%--------------%%%%---
||oo--------------||----
||-------------|--||----
||-------------|--||----
%%%%%%--%%%%%--|--||----
|||||----|||---|--||----