------------------------
------------------------
------------------------
----------------ooooSo--
----------------S-------
------------------------
--SSSSoo--------------SS
------------------------
---------o--------------
-----------ooooo--------
------------------%%%%--
-----SSS-----------||---
-----------%%%%----||---
------------||-----||---
%%%%--------||-%%%%||-%%
|||---------||--||-||--|