------------------------
------------------------
------------------------
------------------------
------------------------
------------------------
------------------------
-----------------------o
--------------------SS--
------------------------
------%%%%---------%%%%-
-------||-----------||--
-------||-----------||--
-------||-----------||--
XXXXXXX||-XXXXXX----||--
XXXXXXX|X-XXXXXX----||--