------------------------
------------------------
------------------------
------------------------
------------------------
-----o------------------
------------------------
------------------------
------SS----------------
------------------------
-----------%%%%--%------
---|%%%%%%%-||----------
%%-||--||||-||----------
-|-||--||||-||----------
---||--%|||-||--%%--XXX-
---||--||||-||--||--XXXX