------------------------
------------------------
------------------------
------------------------
------------------------
------------------------
----------SSSS----------
------------S-----------
------------------%%%%--
-------------------||---
------------------|||---
------------------|||---
------------------||||--
------------------||||--
%%--%%-----%%%----|||%%%
|---|------||------|||-|