------------------------
------------------------
------------------------
------------------------
------------------------
------------------------
------------------------
------------------------
------------------------
------------------------
------------------------
------------------------
----------%%%%----------
-----------||-----------
%%%%%%%%%%|||-----------
-||||-|||-|||-----------