------------------------
------------------------
------------------------
------------------ooooo-
------------------------
------------------------
SSSoo------------%%%%SSS
------------------|-----
------------------|-----
-------oooo-------|-----
---SSSS%%%------S%%%%%--
-------||---------|||---
-------||---------|||---
-------||---------|||---
%------||---------|||---
--------|---------|||---