------------------------
------------------------
------------------------
------------------------
------------------------
------------------------
------SSSS--%%%%%-----SS
-------------|||--------
-------------|||--------
--------------||--------
-%%%%-----SSS-||%%%%%%--
--||----------|||||||---
--||-----------||||||---
--||-----------||||||---
XXX%%%%--------||||||---
X-||||---------||||||---