------------------------
------------------------
------------------------
------------------------
------------------------
------------------------
---SSooo----------------
--------oo--------------
-------------------SS---
------------------------
%%%-----SSS-----%%%-----
-|---------------|------
-|%%%------------|------
-|||-------------|------
-|||-------------|------
-|||-------------|------