------------------------
------------------------
------------------------
------------------------
------------------------
------------------------
-------SSSSoo-----------
------------------------
------------------------
--ooooo--------oooo-----
--SS-------SSSS%%%------
---------------||-------
---------------||-------
---------------||-------
%%%%%%%%%------||-------
||||||||--------|-------