------------------------
------------------------
------------------------
------------------------
------------------------
------------------------
------------------------
------------------------
--------------SSS-------
------------------------
SSS-------S-----------%%
----------------------||
----------------------||
----------------------||
-%%%%%%--XXXXXX----%%-||
--|--|---XXXXXXX----|-||