------------------------
------------------------
------------------------
-----------ooo---------o
------------------------
------------------------
---SSS-----SSSSS--------
------------------------
%%%%---------S----------
-||--------SSS----------
-||%%%%%%---------------
-|||||||----------------
-|||||||----------------
-|||||||----------------
-|||||||----------%%%%%%
-|||||||-----------||||-