------------------------
------------------------
------------------------
------------------------
------------o-----------
--------SSS-------------
------------------------
-----------------------S
---------------SSS------
------------SSS---------
%%%%--------------------
|||---------------------
|||---------------------
||----------------------
||XXXXXX-%%%%-------%%%-
||XXXXXX-%||---------|--