------------------------
------------------------
------------------------
------------------------
------------------------
------------------------
-----S-%%%%-------------
--------||--------------
---------|--------------
---------||-------------
%-----SS-||-------------
---------||-------------
---------||-------------
---------||-------------
%%%------|||-%%%%%%%%---
-|-------|||--||||||----