------------------------
------------------------
------------------------
------------------------
------------------------
------------------------
------------------------
------------------------
--------SS------------SS
------------------------
-----%%%%%--SSS----%----
------|||---------------
------|||---------------
------|||---------------
XXXX---||---%%%%%%%%%%%%
XXXX---||----||--||---||