------------------------
------------------------
------------------------
------------------------
------------------------
------------------------
------------------------
------------------------
------------SSSoo-------
------------------------
------------------------
--------%%%%%-----------
---------|||------------
--------||||------------
XX-%%%%%||||%%%%%-------
-XX--|--||||-|||--------