------------------------
------------------------
------------------------
------------------------
------------------------
-o----------------------
------------------SSoo--
------------------------
-----SSSS-------SS------
------------------------
%%%%%------%%%%-----SSS-
-|||--------||------S---
-|||--------||----------
-|||--------||---------|
-|||-%%%%%%%%|---------|
-|||--|-||-|||---------|