------------------------
------------------------
------------------------
------------------------
------------------------
------------------------
------------------------
------------------------
--------------------SSSo
------------------------
S----%%%----------------
--%%%||---------%%%%%---
---||||----------|||----
---||||---------||||----
%%-||||-XX-%%%%%||||%%%%
---||||--XX--|--||||-|||