------------------------
------------------------
------------------------
------------------------
---------------------%%%
----------------------||
---------%%%%---------||
----------||----------||
----------||----------||
----------||----------||
--------S-||%%%%------||
----------||-||-------||
----------||-||-------|-
----------|||||-------|-
%%%%------|||||-%%%-----
|||-------|||||-||------