------------------------
------------------------
------------------------
------------------------
------------------------
-o----------------------
---------------SS%%%%---
------------------||----
-------S----------||----
------------------||----
---------%%%%-----||----
----------||------||----
-------|--||------||----
-------|--||------||----
%%%%%--|--||------|||%%%
-|||---|--||-------|||||