------------------------
------------------------
------------------------
------------------------
------------------------
------------------------
------------------------
------------------------
----S-S-----------------
------------------------
---%%%----SS-%%%%%------
----|---------||--------
----|---------||--------
----|---------||--------
%%%%|---------||%%%%%%%%
--|-|---------||--||--||