------------------------
------------------------
------------------------
oSo---------------------
------------------------
------------------------
---SSS------------------
--------o---------------
---------------------SSS
------------------------
%%%-----SSSS------------
||----------------------
||----------------------
||----------------------
||-%%%%%%%%%%%%%%%%%%-XX
||--|||||||---||||||--XX