------------------------
------------------------
--------------------%%%-
---------------------|--
---------------------|--
---------------------|--
-------S-------------|--
---------------------|--
-------------------S-|-S
------------------------
%%----------------------
|-----------------------
|-%%%-------------------
|-||--------------------
|-||-%X%XX---%%%%%%%%%%-
|-||-||-XX-----|||||||--