------------------------
------------------------
------------------------
------------------------
------------------------
------------------------
SS----------------------
------------------------
------------------------
----------oo------------
S%%%%-----------------%%
--|-------------------||
--|-------------------||
----------------------||
XXXXXXXXXXXX%%--%%%%%%||
XXXXXXXXXXXX|-----|||-||