------------------------
------------------------
------------------------
------------------------
------------------------
------------------------
S-----------------------
----------|-------------
---------%%%------o-----
----------|-------------
----------|%%%----------
----------|-|------%%%%%
----------|---------||||
----------|---------||||
%--%%%%%%%XXXXXXX-%%||||
----|||||-XXXXXX----||||