------------------------
------------------------
------------------------
------------------------
------------------------
------------------------
---SS-------------------
--------------|---------
-------------%%%------o-
--------------|---------
%-------------|%%%------
--------------|-|------%
--------------|---------
--------------|---------
%%%%%--%%%%%%%XXXXXXX-%%
-|||----|||||-XXXXXX----