------------------------
------------------------
------------------------
------------------------
------------------------
------------------------
---------------SSS------
----------------S-------
-------SS---------------
------------------------
%%----------------------
-----------------------|
-----------------------|
-----------------------|
XXXXX-XXX---XXXXXXX----|
XXXXXX-XX---XXXX-XX----|