------------------------
------------------------
------------------------
------------------------
------------------------
oo----------------------
------------------SSS---
------------------------
SSS--------------------S
------------|-----------
------------|%%---------
--------------|---------
------------|-|---------
-------------||---------
XXXXXX%%%%%%%%%%%%%%%%--
XXXXXX---|||-||-||||----