------------------------
------------------------
------------------------
-----oo-----------------
--S---------------------
------------------------
----SSSSSS--------------
------------------------
------------------------
------------------------
%%%%-SSSS%%%%%%%--------
|||--------||||---------
|||--------||||---------
|||--------||||---------
|||--------||||--%%|XXXX
||---------||||---||-XXX