------------------------
------------------------
------------------------
--------------------SSoo
-----------------------%
------------------------
---------------%-------S
-------o----------------
------------------------
------------------------
%%%--S------%%%%%%------
||-----------||||-------
||-----------||||-------
||-----------||||-------
||-%---------||||----%%%
||-----------||||-----||