------------------------
------------------------
------------------------
------------------------
------------------------
------------------------
%%%S--------------------
-||---------------------
-|---------S------------
-|----------------------
-|--%%%%%%-%%%%%%%------
-S---||||----||-|------|
-----||||----||-|---%%-|
-----||||----||-|----|-|
-----||||-%%%%%%%%%----|
-----||||--||||-||-----|