------------------------
------------------------
------------------------
------------------------
------------------------
------------------------
SS----------------------
------------------------
------------------------
------------------------
---SS-%%%%%---------%%%%
-------|||-----------||-
-------|||-----------||-
-------|||-----------||-
-------|||---%%%%%%%-||-
-------|||----|||----||-