------------------------
------------------------
------------------------
------------------------
---o-S%%%%--------------
-oo-----|---------------
SS------|------%%%%%----
--------|-------|||-----
----SS--|-------|||----S
--------|-------|||-----
--------%%%%%---|||-----
----------||-----%%%%%%%
----------||------||||||
----------||------||||||
----%----|||------||||-|
---------|||------||||-|