------------------------
------------------------
------------------------
------------------------
------------------------
------------------------
-------------------SSSSo
------------------------
-----SS-----------------
--------------ooooo-----
--%-----S-----SS-------S
------------------------
------------------------
------------------------
%%%%%%%%%%%%%%%%%%%%%---
||---|||||||||||||||----