------------------------
------------------------
------------------------
---------oo-------------
------S-----------------
------------------------
--------SSSSSS----------
------------------------
Sooo--------------------
------------------------
---%%%%%-SSSS%%%%%%%----
----|||--------||||-----
----|||--------||||-----
----|||--------||||-----
----|||--------||||--%%|
----||---------||||---||