------------------------
------------------------
------------------------
-------------------oo---
------------------------
ooo-------oo------------
-----------------oo---%%
----------------ooo-----
%----%%%%%-SSSSS-------|
------|||--------------|
------|||---------SSS--|
------|||--------------|
------|||-------------||
------|||-------------||
------|||-%%----------||
------|||-------------|-