------------------------
------------------------
------------------------
------------------------
------------------------
---------|--------------
---S-----|----SSS--o----
---------|-----------ooo
---------|--------------
---------|--------------
%---------%%%------%%SSS
-----------||-%%%-||----
-----------||--||-||----
-----------||--||-||----
%%%%-------||-%||%||----
-||--------||--||-||----