--D--------------D------
--D--------------D------
--D--------------D------
--D--------------D------
--D--------------D------
--D--------------D------
--D--------------D------
--D--------------D------
--DDDDDDDDDDD----DDDDDDD
------------------------
------------------------
------o--------Y--------
------o--------Y--------
------o-----Dy-D---XyX-X
XX----X-----XXXXX--XXX-X
XX----X-----XXXXX--XXX-X