-------------D----------
-------------D----------
-------------D----------
-------------D----------
-------------D----------
-------------D----------
--o----------D----------
-Xo----------D----------
-Xo----------D----------
XXXTTXXXXXX--D----------
XXXttXXXXXX--DDDDDDDDDDD
---tt-------------oo----
---tt-------------------
---tt--------k--y----y--
---tt-------XXXXXXXXXXXX
---tt-------XXXXXXXXXXXX