-------------D----------
-------------D----------
-------------D----------
-------------D----------
-------------D----------
-------------D----------
-------------D----------
---------D---D----------
-------------DDDDDDDDDDD
DDDDDDDDDD--------------
-------D---X------------
-------D---X------------
---------o-XXooooooooooo
---r-----*-XX---y--y--y-
XXXXXXXXXXXXXXXXXXXXXXXX
XXXXXXXXXXXXXXXXXXXXXXXX