DDD---------------D-----
D-D---------------D-----
D-D---------------D-----
D-D---------------D-----
D-D---------------D-----
D-D---------------D-----
D-D---------------D-----
D-D----------D----D-----
D-D---------------D-----
D-DDDDDDDDDDDD----DDDDDD
-----------D---X--------
--o--------D---X--------
--*----------o-X------oo
--D----r-----*-X-------y
XXXXXXXXXXXXXXXXXXXXXXXX
XXXXXXXXXXXXXXXXXXXXXXXX