------------------------
------------------------
------------------------
------------------------
------------------------
------------------------
------------------------
------------------------
-------o----------------
------o-o--------------o
-----o-o-o-------------o
----o-o-o-o------------o
-D-----|-------D-------o
-X-k---|----k--XD------r
XXXXXXXXXXXXXXXXXXX----D
XXXXXXXXXXXXXXXXXXX-----