------------------------
------------------------
------------------------
------------------------
------------------------
------------------------
------------------------
------------------------
DDDD--------------------
---------------o--------
---------------o--------
------Y--------o--------
------Y--------o--------
---Dy-D--------o------#-
---XXXXX-------X-----XX-
---XXXXX-------X-----XX-