------------------------
------------------------
------------------------
------------------------
------------------------
------------------------
------------------------
------------------------
------------------------
----------o-------------
----------o--------o----
----------o--------o----
----------o--------o----
-g--------o-----------g-
XXX-------X-----XXXXXXXX
XXX-------X-----XXXXXXXX