------------------------
------------------------
------------------------
------------------------
------------------------
------------------------
------------------------
---------------------D--
------------------------
SS---D--------o----D----
-----D--------o---------
--SSSD--------o------D--
---ooD--------o------D--
---ooD-D------r------D--
XXXXXXXXXX----D----XXXXX
XXXXXXXXXX---------XXXXX