------------------------
------------------------
------------------------
------------------------
------------------------
------------------------
------------------------
------------------------
---------o--------------
--------o-o-------------
-------o-o-o--------o---
---K--o-o-o-o--K----o---
--DD---D---D---D----o---
--X--D---D---D----------
XXXXXXXXXXXXXXXXXXXXXXXX
XXXXXXXXXXXXXXXXXXXXXXXX