------------------------
------------------------
------------------------
------------------------
------------------------
------------------------
------------------------
------------------------
-----------------------o
DDD---------o----------#
------------o---------##
------------o--------###
------------o------o-###
------------o------#-###
TT--X-------X-----XX-XXX
tt--X-------X-----XX-XXX