------------------------
------------------------
--------------------#---
--------------------#---
------------------------
-----------------#------
-----------------#------
-----------------#------
--------------------#---
--------------------#---
--------------------#--o
-------------oo----##--o
----D----#---##---###--o
----D-X--#--y--y--###---
XXXXXXXXXXXXXXXXXXXXXXXX
XXXXXXXXXXXXXXXXXXXXXXXX