----------------D-------
----------------D-------
----------------D-------
----------------D-------
-g--------------D-------
DD--------------D-------
D---------------D-------
----------------D-------
----------------D-------
XXDD---oooooo---D-------
XX-----TTTTTT---D-------
-------tttttt-----------
-------tttttt-D---------
-------tttttt-D---------
-------tttttt-DTTX------
-------tttttt-XttX------