---D---------D---D------
---D---------D---D------
---D---------D---D------
---D---------D---D------
---D---------D---D------
---D---------D---D------
---D---------D---D------
---D---------D---D------
X--D---------D---DDDDDDD
X--DDDDDDDDDDD----------
X-----------------------
X-----------------------
X------ooo---oo---------
X-------y--Y--y----XyX-X
XXXXXXXXXXXXXXXXX--XXX-X
XXXXXXXXXXXXXXXXX--XXX-X