------------------------
------------------------
------------------------
------------------------
------------------------
------------------------
------------------------
--------------o---------
--------------D---------
--------------D---------
--o--------------o------
--o----------*---o------
--o-------*--D---o------
------k---D--D------g--g
XXXXXXXXXXXXXXXXXXXXXXXX
XXXXXXXXXXXXXXXXXXXXXXXX