---D--------------------
---D--------------------
---D--------------------
---D--------------------
---D--------------------
---D--------------------
---D--------------D-----
---D-------------YD-----
---D-------------DD-XXX-
---D--------------D-XXX-
DDD---------g-g-g-D---X-
--------DDDDDDDDDDDX--X-
-------D----------DX--X-
------D-----------D---X-
XXXXXXXXXXXXXXXXXXXXXXX-
XXXXXXXXXXXXXXXXXXXXXXX-