------------------------
------------------------
------------------------
-----------------#-----o
-------------g-###-----o
-----------DDD-----#--y-
---------TTDD------#####
---------tt-------------
---g-g---tt------------#
XXXXXXTTXXXXXX---------#
XXXXXXttXXXXXX----------
------tt----------------
------tt----------------
------tt----------------
------tt----------------
------tt----------------