------------------------
------------------------
------------------------
---------------------o--
--------------------o---
-------------------o----
-------------------#----
------------------##----
------------------##----
---------------o--##----
---------------#--##----
----C-S-S-C---##--##----
--------------##--##----
----ooo-----#-##--##----
X--XXXXX-XXXX-XX--XXXXXX
X--XXXXX-XXXX-XX--XXXXXX