------------------------
------------------------
------------------------
------------------------
------------------------
------------------------
------------------------
----------------o-------
----------------D-------
----------------D-------
----o-------------------
----o----------*--------
----o-------*--D----#---
-g------k---D--D-X--#--y
XXXXXXXXXXXXXXXXXXXXXXXX
XXXXXXXXXXXXXXXXXXXXXXXX