-------------------DD---
-------------------DD---
-------------------DD---
-------------------DD---
-------------------DD---
-------------------DD---
-------------------DD---
----------D--------DD---
-------------------DD---
DDDDDDDDDDD---XX---DD---
--------D---X-XX---DD---
--------D---X-D---------
----------o-X-D---------
----r-----*-X-D*--oooo--
XXXXXXXXXXXXX--DDDDDDDDD
XXXXXXXXXXXXX-----------