------------------------
------------------------
------------------------
------------------------
------------------------
----------------D-------
------------------------
-----------------------#
------------TT---------#
------------tt------o--#
--------TToott------#--#
--------ttoott-----##--#
--------ttoott-----##--#
--------ttggtt---#-##--#
--XXXXXXXXXXXXXXXX-XX--X
XXXXXXXXXXXXXXXXXX-XX--X