------------------------
------------------------
-----------------#------
-g---------------#------
XX----------------------
XX------------#---------
-X------------#---------
-X------------#---------
-----------------#------
-----------------#------
-DD--------------#------
-D--------oo----##------
-DD---#---##---###-D----
--DX--#--y--y--###-D----
-DDXXXXXXXXXXXXXXXXXXXXX
---XXXXXXXXXXXXXXXXXXXXX