------------------------
------------------------
------------------------
------------------------
------------------------
------------------------
---o--------------------
---o--------------------
---o------o-------------
---D-----o-o------------
--------o-o-o-----------
--*----o-o-o-o----------
--D-D-----|-------D-----
--D-X-k---|----k--X-----
XXXXXXXXXXXXXXXXXXXX----
XXXXXXXXXXXXXXXXXXXX----