-------D------------D---
-------D------------D---
-------D------------D---
-------D------------D---
-------D------------D---
-------D------------D---
-------D------------D---
-------D------------D---
-------D------------D---
o------D------------D---
o------DDDDDDDDDDDDD----
o-----------oo----------
------------------------
D-gD-g-k--y----y-----X-X
XXXXXXXXXXXXXXXXXXXXXXXX
XXXXXXXXXXXXXXXXXXXXXXXX