------------------------
------------------------
------------------------
------------------------
------------------------
------------------------
------------------------
------------------------
------------------------
-----X------------------
----XX------------------
-----X-------C-S-S-C----
-----X------------------
--X-X--------ooo-----D--
XXXXXXXXXX--XXXXX-XXXXXX
XXXXXXXXXX--XXXXX-XXXXXX