---------D---D----------
---------D---D----------
---------D---D----------
---------D---D----------
---------D---D----------
---------D---D----------
---------D---D----------
---------D---D----------
---------D---DDDDDDDDDDD
DDDDDDDDDD-------------D
-----------------------D
------------------------
---ooo---oo-------------
----y--Y--y----XyX-XyXyX
XXXXXXXXXXXXX--XXX-XXXXX
XXXXXXXXXXXXX--XXX-XXXXX