------------------------
------------------------
------------------------
------------------------
------------------------
------------------------
------------------------
------------------------
---o--------------o-----
--o-o------------o-o----
-o-o-o----------o-o-o---
o-o-o-o-----K--o-o-o-o--
---|-------DD---D---D---
---|----k--X--D---D---D-
XXXXXXXXXXXXXXXXXXXXXXXX
XXXXXXXXXXXXXXXXXXXXXXXX