----------------DD------
-----------------D------
-----------------D------
-----------------D------
-----------------D------
-----------------D------
-----------------D------
---------------D-D------
-----------------D------
--------o----D---DDDDDDD
--------o---------------
--------o------D-o------
--------o------D-*------
-D------r------D-D----r-
XXXX----D----XXXXXXXXXXX
XXXX---------XXXXXXXXXXX