--D---------------------
--D---------------------
--D---------------------
--D---------------------
--D---------------------
--D---------------------
--D---------------------
--D---------------------
--D---------------------
--D--------o------------
--D--------o------------
-----------o-----------o
D----------o-----------o
D----------o------X-X--o
DTTX-------X-----XXXXXXX
XttX-------X-----XXXXXXX