------------------------
------------------------
----------------#-------
----------------#-------
------------------------
-------------#----------
-------------#----------
-------------#----------
----------------#-------
----------------#-------
----------------#--o----
---------oo----##--o----
D----#---##---###--o----
D-X--#--y--y--###-----g-
XXXXXXXXXXXXXXXXXXXXXXXX
XXXXXXXXXXXXXXXXXXXXXXXX