------------------------
------------------------
------------------------
------------------------
-----g------------------
---DDD------------------
-TTDD-------------------
-tt---------------------
-tt----------D----------
XXXXXX--SSS@SSSS---D----
XXXXXX---------S---D----
----------------SSSD----
--------oo-------ooD----
--------oo--g----ooD-D--
------XXXXXXXXXXXXXXXXXX
------XXXXXXXXXXXXXXXXXX