--D---------D-----------
--D---------D-----------
--D---------D-----------
--D---------D-----------
--D---------D----------o
--D---------D---------o-
--D---------D---------#-
--D---------D--------##-
--D---------D--------##-
--DDDDDDDDDDD-----o--##-
------------------#--##-
-----------------##--##-
------ooo---oo---##--##-
-------y--Y--y-#-##--##-
XXXXXXXXXXXXXXXX-XX--XXX
XXXXXXXXXXXXXXXX-XX--XXX