------------------------
------------------------
------------------------
------------------------
------------------------
------------------------
------------------------
----------o-------------
----------D-X-----------
----------D-X-----------
------------X-----------
---------*--X-----------
------*--D--X-----------
--k---D--D--X-r-----r---
XXXXXXXXXXXXXXX--XX-XX-X
XXXXXXXXXXXXXXX--XX-XX-X