------------------------
------------------------
------------------------
---------D--------------
---------D--------------
--------DD--------------
------D--D--------------
---------D--------------
----k----D--------------
XXXXXXXXXX--------o-----
XXXXXXXXXX--------o-----
------------------o-----
------------------o-----
------------------o-----
----------X-------X-----
----------X-------X-----