------------------------
------------------------
---------------------#--
---------------------#--
-----------------------#
------------------#-----
------------------#-----
------------------#-----
---------------------#--
XXXXXX---------------#--
XXXXXX---------------#--
--------------oo----##--
----------#---##---###--
-------X--#--y--y--###--
-------XXXXXXXXXXXXXXX--
-------XXXXXXXXXXXXXXX--