------------------------
------------------------
------------------------
------------------------
-----------g------------
---------DDD------------
-------TTDD-------------
-------tt---------------
-g-g---tt---------------
XXXXTTXXXXXX------------
XXXXttXXXXXX--------g-g-
----tt----------DDDDDDDD
----tt---------D--------
----tt--------D---------
----tt------XXXXXXXXXXXX
----tt------XXXXXXXXXXXX