-----------------D------
-----------------D------
-----------------D------
-----------------D------
-----------------D------
X----------------D------
X----------------D------
X----------------D------
X----oooo-----g--D------
X##--####--#####-D------
X-#-y#--#-y#-----DDDDDDD
X--##----##-----------oo
X-----------------------
X----------------k--y---
X---------------XXXXXXXX
X---------------XXXXXXXX