-----------------------
-----------------------
-----------------------
---------------o--o----
-----------------------
-----------------------
---------------#-------
-------o-----g##-------
-------D-----###-------
-------D---g####-------
-----------#####-------
------*--g######-------
---*--D--#######-------
---D--D-########----#--
XXXXXXXXXXXXXXXXXXXXXXX
XXXXXXXXXXXXXXXXXXXXXXX