------------------------
------------------------
------------------------
------------------------
------------------------
------------------------
------------------------
------------------------
------------------------
------------------------
--------------------TT--
------C-S-S-C------otto-
-------------------otto-
------ooo-----X-X--otto-
XXX--XXXXX-XXXXXXXXXXXXX
XXX--XXXXX-XXXXXXXXXXXXX