------------------------
------------------------
--------------#---------
--------------#---------
--------------------oo--
-----------#------------
-----------#------------
-----------#------------
--------------#-XXX----X
--------------#-XXX----X
--------------#---X-----
-------oo----##X--X-----
---#---##---###X--X-----
X--#--y--y--###---X-----
XXXXXXXXXXXXXXXXXXX-----
XXXXXXXXXXXXXXXXXXX-----