------------D-----------
------------D-----------
------------D-----------
---X--gX-g--DD----*----D
XXXXXXXXXX--------D-----
XXXXXXXXXX--------D-----
---------X--XXXXXXXXXXXX
---------X--------------
------------------------
------------------------
-DD--D-D-DD-------------
-D-D-D-D-D--------------
-DD--D-D-DD-------------
-D-D--D---D-------------
-D-D--D--DD-------------
------------------------