------------------------
------------------------
------------------------
----D-------------------
----D-------------------
---DD-------------------
-D--D-------------------
----D-------------------
----D----oooo-----g-----
XXXXX##--####--#####----
XXXXX-#-y#--#-y#--------
-------##----##---------
-----------------------D
----------------------D-
--------------------XXXX
--------------------XXXX