------------------------
------------------------
------------------------
------------------------
------------------------
------------------------
------------------------
-----------------D------
------------------------
----------o----D--------
----------o-------------
----------o------D--2122
-D--------o------D------
-D-D------r------D--g--g
XXXXXX----D----XXXXXXXXX
XXXXXX---------XXXXXXXXX