------------------------
------------------------
------------------------
---------D--------------
---------D--------------
--------DD--------------
------D--D--------------
---------D-------------X
----k----D-XXX--XXXXX-XX
XXXXXXXXXX-XXX--XXXXX-XX
XXXXXXXXXX-------------o
----------X------------o
----------X------------o
------------------g----o
----------XXXX--XXXXX-XX
----------XXXX--XXXXX-XX