------D------------D----
------D------------D----
------D------------D----
------D------------D----
------D------------D----
------D------------D----
------D------------D----
------D------------D----
------D------------D----
------D------------D--SS
------DDDDDDDDDDDDD-----
-S-C-------oo-----------
----------------------oo
------k--y----y-------oo
X-XXXXXXXXXXXXXXXXXXXXXX
X-XXXXXXXXXXXXXXXXXXXXXX