----D------------D------
----D------------D------
----D------------D------
-g--DD----*----DD-------
XX--------D-------------
XX--------D-------------
-X--XXXXXXXXXXXXX-------
-X----------------------
------------------------
------------------------
-DD---------------------
-D---------------------o
-DD--------------------o
--D---------------X-X--o
-DD---------------XXXXXX
------------------XXXXXX