D-----------------------
D-----------------------
D-----------------------
D------------D----------
D*-----------D-X--------
DD----------DD-XXX----XX
D---------D--D-XXX----XX
-------------D-XXXX---XX
---k----k----D-XXX----XX
XXXXXXXXXXXXXX-XXX---XXX
XXXXXXXXXXXXXX-XXX----XX
---------------XXXX---XX
---------------XXX----XX
---------------XXX---XXX
---------------XXXooooXX
---------------XXXXXXXXX