--DD---------------D----
---D---------------D----
---D---------------D----
---D---------------D----
---D---------------D----
---D---------------D----
---D---------------D----
---D----------D----D----
---D---------------D----
X--DDDDDDDDDDDD----DDDDD
X-----------D---X-------
---o--------D---X-------
---*----------o-X------o
---D----r-----*-X-------
--XXXXXXXXXXXXXXXXXXXXXX
--XXXXXXXXXXXXXXXXXXXXXX