----------D------------D
----------D------------D
----------D------------D
----------D------------D
----------D------------D
----------D------------D
----------D------------D
----------D------------D
----------D------------D
----------D------------D
----------DDDDDDDDDDDDD-
-C-S-S-C-------oo-------
------------------------
-ooo------k--y----y-----
XXXXX-XXXXXXXXXXXXXXXXXX
XXXXX-XXXXXXXXXXXXXXXXXX