------------------------
-------------------L----
------------------------
------------------K-----
---------------%%%%%----
---------------%%%%%----
-----o-----------||-----
-----o---k---k---||-----
-----o-%%%%%%%%%%%%%----
-----D-%%%%%%%%%%%%%----
-------------||---------
----*--------||---------
-*--D--------||---------
-D--D--------||------D--
XXXXXX-------||------XXX
XXXXXX-------||------XXX