-------------D----------
-------------D----------
-------------D----------
-------------D----------
-------------D----------
-------------D----------
-------------D----------
-------------D----------
----D--------D----------
SS@SSSS---D--D----------
----------D--DDDDDDDDDDD
-------SSSD-------oo----
o-------ooD-------------
o--g----ooD--k--y----y--
XXXXXXXXXXXXXXXXXXXXXXXX
XXXXXXXXXXXXXXXXXXXXXXXX