------------------------
------------------------
------------------------
------------------------
------------------------
------------------------
------------------------
------------------------
----o-------------------
---o-o------------------
--o-o-o-----------------
-o-o-o-o--K---------oo--
--D---D---D-----#---##--
D---D---D----X--#--y--y-
XXXXXXXXXXXXXXXXXXXXXXXX
XXXXXXXXXXXXXXXXXXXXXXXX