---------DDD------------
---------D-D------------
---------D-D------------
---------D-D------------
---------D-D------------
---------D-D------------
---------D-D------------
---------D-D----------D-
---------D-D------------
-----k---D-DDDDDDDDDDDD-
XXXXXXXXo-----------D---
-------Xo--o--------D---
-------Xo--*----------o-
-------Xo--D----r-----*-
-------XXXXXXXXXXXXXXXXX
-------XXXXXXXXXXXXXXXXX