------------------------
------------------------
------------------------
------------------------
------------------------
------------------------
------------------------
------------------------
-g----------------------
####--------o-----------
------------o----------o
------------o---------o-
------------o------D----
------------o------X-k--
----X-------X-----XXXXXX
----X-------X-----XXXXXX