------------------------
------------------------
------------------------
------------------------
------------------------
------------------------
------------------------
------------------------
------------------------
------------------------
------------------------
-S-C--------------------
------D-----*-----D-----
------D-----D-----D-D---
X-XXXXXXXXXXXXXXXXXXXXX-
X-XXXXXXXXXXXXXXXXXXXXX-