----------------D-------
----------------D-------
----------------D-------
----------------D-------
----------------D-------
----------------D-------
--------------o-D-------
--------------o-D-------
--------------o-D-------
--------------D-D-------
--o-------------DDDDDDDD
--o----------*-------oo-
--o-------*--D----------
-----g--g-D--D--k--y----
XXXXXXXXXXXXXXXXXXXXXXXX
XXXXXXXXXXXXXXXXXXXXXXXX