------------------------
----------------------o-
----------------------o-
----------------------D-
---------------------D--
--------------------D---
------------------------
----------D---DDDD------
----------------------D-
DDDDDDDDDDD--D--------D-
--------D---X---------D-
--------D---X-----------
----------o-X-----------
----r-----*-X-----------
XXXXXXXXXXXXXXXXXXXXXXXX
XXXXXXXXXXXXXXXXXXXXXXXX