------------------------
------------------------
------------------------
------------------------
------------------------
------------------------
------------------D-----
-----------------YD-----
-----------------DD----o
------------------D-DD-D
------------g-g-g-D-----
-K------DDDDDDDDDDD-----
-D-----D----------D-----
------D-----------D-----
XXXXXXXXXXXXXXXXXXX-----
XXXXXXXXXXXXXXXXXXX-----