----------D-------------
----------D-------------
----------D-------------
----------D---------o---
----------D--------o----
----------D-------o-----
----------D-------#-----
----------D------##-----
----------D------##-----
------k---D---o--##-----
XXXXXXXXXo----#--##-----
--------Xo---##--##-----
--------Xo---##--##-----
--------Xo-#-##--##----#
--------XXXX-XX--XXXXXXX
--------XXXX-XX--XXXXXXX