------------------------
------------------------
------------------------
------------------------
------------------------
------------------------
X-----------------o-----
X-----------------o---r-
X-----------------o%%%%%
X-----------------D%%%%%
XX----o-----------------
XXX---o----------*------
XXX---o-------*--D------
XXXX-----g--g-D--D------
XXXXXXXXXXXXXXXXXXX-----
XXXXXXXXXXXXXXXXXXX-----