-----------------------U
------------------------
-----------------------D
------------------------
-----------------------D
------------------------
-----------------DD----D
----------------YDD--g--
-g--------------DDDDDDDD
###--------------D------
-----------g-g-g-D------
-------DDDDDDDDDDD---ooo
------D----------D---o-o
-----D-----------D---ooo
---XXXXXXXXXXXXXXX------
---XXXXXXXXXXXXXXX------