---------D--------------
---------D--------------
---------D--------------
---------D--------------
---------D--------------
---------D--------------
---------D--------------
---------D--------------
oo----------------------
------------------------
--------o---o-----------
-g------o---o----------*
DD------o---o-------*--D
--------g-------k---D--D
-------DD-XXXXXXXXXXXXXX
----------XXXXXXXXXXXXXX