---------D-----D--------
---------D-----D--------
---------D-----D--------
--#-----oD-----D--------
###-----oD-----D--------
----#--y-------D--------
----#####------D--------
---------------D--------
--------#g-g---D--------
--------######-D--------
---------------DDDDDDDDD
--------------------oo--
------------------------
---------------k--y----y
--------------XXXXXXXXXX
--------------XXXXXXXXXX