------------------------
------------------------
------------------------
SSSSSSSSSSSSSSSSSSSSSSSS
SSSSSSSSSSSSSSSS--------
SSSSSSSSSSSSSSSS--------
SSSSSSSSSSSSSSSS--------
S-------------------TT--
S-------------------TT--
--oooooooooo--------TT--
-USSSSSSSSSS----#---TT--
---------------##---TT--
--------------###---TT--
--------kk---####--kTT--
XXXXXXXXXXXXXXXXXXXXXXX-
XXXXXXXXXXXXXXXXXXXXXXX-