------------------------
------------------------
------------------------
------------------------
------------------------
------------------------
------------##----------
------------##----------
----------#-##----------
----------#-##----------
--------#-#-##----------
--------#-#-##----------
-TT---#-#-#-##----------
-TT---#-#-#-##--------#-
XXXXX-X-X-X-XXXXXXXXXXXX
XXXXX-X-X-X-XXXXXXXXXXXX