------------------------
------------------------
------------------------
------------------------
------------------------
------------------------
SS------SSSS------------
------------------------
------------------------
-------------------g----
-QQQ---------------TT---
-------------------TT---
-------------------TT---
----ggg------------TT---
XXXXXXXX----XXXXXXXXXX--
XXXXXXXX----XXXXXXXXXX--