------------------------
------------------------
------------------------
------------------------
------------------------
------------------------
--------US--------------
------------------------
------------------------
------------------------
-------####--SSC--------
--y-#####---------------
-######-----------------
#####------------------y
XXX------XX--XXXXXXXXXXX
XXX------XX--XXXXXXXXXXX