------------------------
------------------------
------------------------
------------------------
------------------------
----------------------k-
SSC------------------SQS
------------------------
-----------g#-----------
SSS-------g##-----------
----------###--------SQS
---------####-----------
--------#####-----------
-------######------k----
---XXXXXXXXXX--XXXXXXXXX
---XXXXXXXXXX--XXXXXXXXX