------------------------
------------------------
------------------------
--D---------------------
-DD---------------------
--D---------------------
--D---------------------
--D---------------------
--D---------------------
--D---------o---------o-
--D---------o---------#-
--D---------o--------##-
--D---------o--------##-
--D---------o------#-##-
X-XXX-------X-----XX-XX-
X-XXX-------X-----XX-XX-