--D-D-------------------
--D-D-------------------
--D-D-------------------
--D-D-------------------
--D-D-------------------
--D-D-------------------
--D-D------o------------
--D-D-----o-o-----------
--D-D----o-o-o----------
--D-DDDDDDDDDDDDD-------
Xo----------------------
Xo---------------------o
Xo-------TT------------o
Xo-------tt-------X-X--o
XXX--TT--tt---TT--XXXXXX
XXXX-tt--tt---tt--XXXXXX