--D---------------------
--D---------------------
--D---------------------
--D---------------------
--D---------------------
--D---------------------
--D------o--------------
--D-----o-o-------------
--D----o-o-o------------
--DDDDDDDDDDDDD--------o
-----------------------o
-----------------------o
-------TT--------------o
-------tt-------D------r
X--TT--tt---TT--XXX----D
XX-tt--tt---tt--XXX-----