--------------D-----D---
--------------D-----D---
-YYY----------D-----D---
-DDD---#-----oD-----D---
---D-###-----oD-----D---
---D-----#--y-------D---
-D-D-----#####------D---
-o-D----------------D---
-o-D---------#g-g---D---
DDDD---------######-D---
--------------------DDDD
------------------------
------------------------
--------------------k--y
-------------------XXXXX
-------------------XXXXX