------------------------
------------------------
------------------------
------------------------
------------------------
----------k-------------
----------##------------
---------###------------
--------####------------
-------#####------------
------######------------
-----#######------------
----########--------F---
---#########--------#---
XXXXXXXXXXXXXXXXXXXXXXXX
XXXXXXXXXXXXXXXXXXXXXXXX