-----------------------
-----------------------
-----------------------
-----------------------
-----------------------
-----------------------
-----------------------
-----------------------
-----------------------
--------Q--?-----------
-----Q---------SSS-----
-----------------K---TT
---------------------TT
--------------K------TT
XXXXXXXXXXXXXXXXXXXXXXX
XXXXXXXXXXXXXXXXXXXXXXX