------------------------
------------------------
------------------------
-----------------------o
------------------------
------------------------
----------------------SS
------------------------
------------------------
------------------------
----------------%%%%----
-----------------||-----
-----------------||-----
-M---------------||-----
XXXXXXXXXXX--%%%%||%%%%-
XXXXXXXXXXX---||-||-||--