-----------------------
-----------------------
-----------------------
-----------------------
-----------------------
-----------------------
----------------USS----
-----------------------
-----------------------
-----------------------
-----------------------
-------------K---*-----
--------*--------*-----
--------*--------B-----
XXXXXXXXXXXXXXXXXXXXXXX
XXXXXXXXXXXXXXXXXXXXXXX