-----------------------
-----------------------
-----------------------
-----------------------
-----------------------
-----------------------
-----------------------
---------------y-------
-------------#SS--o----
------------##---------
-----------###--SC-----
----------####---------
---------#####---SSS---
-----y--######---------
X-XXXXXXXXXXXX------XXX
X-XXXXXXXXXXXX------XXX