------------------------
------------------------
------------------------
------------------------
------------------------
------------------------
------------------------
------------------------
------------------------
------------------------
---------------------S--
-----------------TT-----
-----------------TT-----
--------------gggTT-----
XXXXX---XXXXXXXXXXXXXXXX
XXXXX---XXXXXXXXXXXXXXXX