------------------------
------------------------
------------------------
------------------------
------------------------
------------------------
----oo------------------
------------------------
------------------------
----------------SSS-----
%%%%--%%%%------------##
-||----||-------------##
-||----||-------------##
-||----||---------r---##
-||----||----XXXXXXXXXXX
-||----||----XXXXXXXXXXX