-----------------------
-----------------------
-----------------------
---------------------U-
-----------------------
-----------------------
----SSSSS--------------
-----------------------
-----------------------
-----K-------------SS--
----SSSSS--------------
-------K---#----*------
-----------#----*------
-----------#----*------
XXXXXXXXXXXXXXXXXXXXXX-
XXXXXXXXXXXXXXXXXXXXXX-