------------------------
------------------------
------------------------
------------------------
------------------------
------------------------
---US---SS-------------S
------------------------
------------------------
-SS---------------------
-------SSS---------#---S
--------------#-TT-#----
-------------##-TT-##---
------------###-TT-##---
XXXX-X-XXXXXXXX-XXXXXXXX
XXXX-X-XXXXXXXX-XXXXXXXX