------------------------
------------------------
------------------------
SSSSSSSSSSSSSSSSSSSS----
------------------------
------------------------
------------------------
------------------------
-----------------------S
------------------------
---------------TT-------
------------#--TT--##---
-----------##--TT--##---
--------kk-##--TT--##---
XXXXXXXXXXXXX--XX--XX---
XXXXXXXXXXXXX--XX--XX---