------------------------
------------------------
------------------------
------------------------
------------------------
o----------R------------
%----------------g----oo
-------------%%%%%%-----
--------------||||------
--------------||||-----S
-------%%%----||||------
--------|-----||||------
--------|-----||||------
--------|-----||||------
%-%%%%%-|-----||||------
---|||--|-----||||------