-----------------------
-----------------------
-----------------------
-----------------------
-----------------------
-----------------------
-----------------------
-----------------------
-----------------------
---o----o--------------
-----------------------
-----------------------
---------------#---#---
---------------#-k-#---
XX---XX---XXXXXXXXXXXXX
XX---XX---XXXXXXXXXXXXX