-----------------------
-----------------------
-----------------------
-----------------------
-----------------------
-----------------------
--------------!--------
-----------------------
-----------------------
-----------------------
--------!---S@S!S------
-----------------------
--------------------tt-
-------------g------tt-
XXXXXXXXXXXXXXXXXXXXXXX
XXXXXXXXXXXXXXXXXXXXXXX