------------------------
------------------------
------------------------
------------------------
------------------------
------------------------
------------------------
-----------oooo---------
------------------------
------------------------
----------------------TT
---------#------------TT
---------#------------TT
---------#---------y--TT
XXXXXXXXXXXXXXXXXXXXXXXX
XXXXXXXXXXXXXXXXXXXXXXXX