-----------------------
-----------------------
-----------------------
-----------------------
-----------------------
K----------------------
SS----1----------------
-----------------------
-----------------------
-----------------------
SS---------------------
------TT--------------T
------TT---------*----T
------TT---------*----T
XXXXXXXXXXXXXXXXXXXXXXX
XXXXXXXXXXXXXXXXXXXXXXX