-----------------------
-----------------------
-----------------------
-----------------------
-----------------------
-----------------------
----------------------S
-----------------------
-----------------------
-----------------------
-------------------C---
------------#----------
--------K---#----------
------------#-----gg---
XXXXXXXXXX--XXXXXXXXXXX
XXXXXXXXXX--XXXXXXXXXXX