-----------------------
-----------------------
-----------------------
-----------------------
-----------------------
-----------------------
USSS-------------------
-----------------------
-----------------------
-----TT----------------
-----TT----------------
-tt--TT----------------
-tt--TT----------------
-tt--TT-----k----------
XXXXXXXXXXXXXX---XXXXXX
XXXXXXXXXXXXXX---XXXXXX