------------------------
------------------------
------------------------
------------------------
------------------------
------------------------
------------------------
------------------------
--------------TT--------
--------------TT--------
-----#LSS-----##--------
-----#------------------
-----#-----------*---TT-
---kk#-----------*---TT-
XXXXXXXXXX---XXXXXXXXXXX
XXXXXXXXXX---XXXXXXXXXXX