------------------------
------------------------
------------------------
------------------------
------------------------
------------------------
------------------------
---------------y--------
-------------#SS--o-----
------------##----------
-----------###--SC------
----------####----------
---------#####---SSS----
-----y--######----------
X-XXXXXXXXXXXX------XXXX
X-XXXXXXXXXXXX------XXXX