-----------------------
-----------------------
-----------------------
-----------------------
-----------------------
-----------------------
-----------------------
-----------------------
-----------------------
-----------------------
--S--------------######
----------------##-----
--------TT-----###-----
------k-TT----####-----
XXXXXXXXXXXXXXXXXX-----
XXXXXXXXXXXXXXXXXX-----