------------------------
------------------------
------------------------
------------------------
------------------------
------------------------
------------------------
-------y----------------
-----#SS--o-------------
----##------------------
---###--SC--------------
--####------------------
-#####---SSS------------
######------------------
XXXXXX------XXXXXXXXX---
XXXXXX------XXXXXXXXX---