------------------------
------------------------
------------------------
------------------------
------------------------
------------------------
-----------SSS----------
------------------TT----
------------------TT----
------------------TT----
-------#---SSS----XX----
--#-TT-#----------------
-##-TT-##---------------
###-TT-##---------k-----
XXX-XXXXXXXXXXXXXXXXXXXX
XXX-XXXXXXXXXXXXXXXXXXXX