-----------------------
-----------------------
-----------------------
-----------------------
--g-g------------------
%%%%%-------------oooo-
||||--------------%%%%-
||||----oo---SSSS--||--
||||---------------||--
||||---------------||--
||||---------------||--
||||-------------U-||--
||||---------------||--
||||---------------||--
||||----%%%%-----%%%%%-
||||-----||-------|||--