-----------------------
-----------------------
-----------------------
-----------------------
-----------------------
-----------------------
-----------------------
-----oooo------------oo
-----------------------
-----------------------
--TT--------------TT---
--TT--------------TT---
--TT--------------TT---
--TT---y------y---TT---
XXXXXXXXXXXXXXXXXXXXXXX
XXXXXXXXXXXXXXXXXXXXXXX