------------------------
------------------------
------------------------
---SSSSSSSSSSSSSSSSSSSSS
------------------------
------------------------
CSS---------------------
--------------TT--------
2-------------TT--------
-2------------TT-------S
--2---------SCTTSU------
--------TT----TT----TT--
--------TT----TT----TT--
--------TT---kTT---kTT--
XXXXXXXXXXXXXXXXXXXXXXXX
XXXXXXXXXXXXXXXXXXXXXXXX