------------------------
------------------------
------------------------
------------------------
------------------------
------------------------
-------------##---------
-------------##---------
--SSS------####---------
-----------####---------
---------######---------
---------######---------
---------######--------F
-----r---######--------#
XXXXXXXXXXXXXXXXXXXXXXXX
XXXXXXXXXXXXXXXXXXXXXXXX