-----------------------
-----------------------
-----------------------
-----------------------
-----------------------
-----------------------
-----------------------
-----------------------
-----------------------
----Q--?---------------
-Q---------SSS---------
-------------K---TT----
-----------------TT----
----------K------TT---g
XXXXXXXXXXXXXXXXXXXXXXX
XXXXXXXXXXXXXXXXXXXXXXX