------------------------
------------------------
------------------------
------------------------
------------------------
-------------X----------
-------------X-----o----
------------XX----Xo----
XXX--XXXXX-XXX----Xo----
XXX--XXXXX-XXX-XXXXXTTXX
------------oX-XXXXXttXX
------------oX------tt--
------------oX------tt--
-------g----oX------tt--
XXX--XXXXX-XXX------tt--
XXX--XXXXX-XXX------tt--