------------------------
----------------o-------
------------------------
------------#---y---#---
---------###############
--------X--------------#
--------X#---y-----y---#
-------XX###############
XXXXX-XXX--------------#
XXXXX-XXX#---y-----y---#
-------oX###############
-------oX---------------
-------oX---------------
--g----oX---------------
XXXXX-XXX---------------
XXXXX-XXX---------------