-------------D----------
-------------D----------
-----------#-D----------
-----------#-D----------
-------------D----------
--------#----D----------
--------#----D------o---
--------#----D-----o-o--
-----------#-D----o-o-o-
-----------#-DDDDDDDDDDD
-----------#------------
----oo----##------------
#---##---###------TT----
#--y--y--###------tt----
XXXXXXXXXXXX--TT--tt---T
XXXXXXXXXXXXX-tt--tt---t