------------------------
------------------------
-YYY--------------------
-DDD--------------------
---D--------------------
---D--------------------
-D-D--------------------
-o-D--------------o-DDDD
-o-D--------------D-----
DDDD--------------DD----
------o-----------------
------o----------*------
------o-------*--D------
----------k---D--D------
----XXXXXXXXXXXXXXXXXXXX
----XXXXXXXXXXXXXXXXXXXX