------------------------
------------------------
------------------------
------------------------
------------------------
------------------------
------------------------
------------------------
------------------------
------------------------
--------------------TToo
--------------------ttoo
D-----*-----D-------ttoo
D-----D-----D-------ttgg
XXXXXXXXXXXXXXXXXXXXXXXX
XXXXXXXXXXXXXXXXXXXXXXXX