--D-D------------D------
--D-D------------D------
--D-D------------D------
--D-D------------D------
--D-D------------D------
--D-D------------D------
--D-D------------D------
--D-D------------D------
--D-D------------D----o-
--D-D----oo-----oD----#-
--D-D-----------*D---##-
----Do---TT---------###-
D---D*---tt--oo---o-###-
D--------tt-------#-###-
DTTXXXX--tt--TT-XXX-XXX-
XttX-----tt--tt---X-XXX-