------------------------
------------------------
------------------------
------------------------
------------------------
------------------------
------------------------
------------------------
------------------------
-----------o------------
-----------o------------
-----------o------------
--D--------o------------
--X--------o------------
XXXX-------X-----XX-----
XXXX-------X-----XX-----