------------------------
------------------------
------------------------
------------------------
------------------------
------------------------
------------------------
------------------------
-----g------------------
--#####-----------------
-y#---------------------
##----------------------
--------D-----*-----D-D-
--------D-----D-----D-X-
-------XXXXXXXXXXXXXXXXX
-------XXXXXXXXXXXXXXXXX