------------------------
------------------------
------------------------
------------------------
------------------------
------------------------
------------------------
------------------------
------------------------
--------------o---------
--------------o---------
--------------o---------
----D---------o------D--
----D---------o------X-k
XXXXXXX-------X-----XXXX
XXXXXXX-------X-----XXXX