------------D-----------
------------D-----------
----!--!----D-----------
------------D-----------
------------D*----------
----!--!----DD----------
------------D---------D-
---------k--------------
XXXXXXXXXX-----k----k---
XXXXXXXXXX--XXXXXXXXXXXX
------------XXXXXXXXXXXX
------------------------
------------------------
------------------------
------------------------
------------------------