------------------------
------------------------
------------------------
------------------------
------------------------
X----XXX----------------
X----XXXX---------------
XX---XXXX---------------
X----XXXX---------------
X---XXXXX---------------
X----XXXXX----o---------
XX---XXXXXX---o---------
X----XXXXXX---o-------*-
X---XXXXXXXX-----g--g-D-
XooooXXXXXXXXXXXXXXXXXXX
XXXXXXXXXXXXXXXXXXXXXXXX