------------------------
------------------------
------------------------
------------------------
--------oo--------------
---------------oX-------
---------------oX-------
--D------------XX-------
----XXX----XX--XX--X----
D---XXX----XX--XX--X----
------X---------X--X----
--DX--X---------X--X----
--DX--X---------X--X----
--D---X---------X--X-r--
XXXXXXX---------X-XXXX--
XXXXXXX---------X-XXXX--