------------------------
------------------------
------------------------
------------------------
------------------------
------------------------
------------------------
------D----------------o
-----------------------D
DDDDDDD----------------D
----D---X--o------------
----D---X--o----------*-
------o-X--o-------*--D-
r-----*-X------k---D--D-
XXXXXXXXXXXXXXXXXXXXXXXX
XXXXXXXXXXXXXXXXXXXXXXXX