------------------------
------------------------
------------------------
------------------------
------------------------
------------------------
-o----------------------
o-o-------------------D-
-o-o--------------------
DDDDDDD--------o----D---
---------------o--------
---------------o------DX
T--------------o------DX
t-------D------r------D-
t---TT--XXX----D----XXXX
t---tt--XXX---------XXXX