-----------------------D
-----------------------D
!--!-------------------D
-----------------------D
-----------------------D
!--!-------------------D
-----------------------D
-----k-----------------D
XXXXXX-----------------D
XXXXXX-----------------D
------------------------
------------------------
--------D-----*-----D---
--------D-----D-----D---
-------XXXXXXXXXXXXXXX--
-------XXXXXXXXXXXXXXXX-