------------------------
------------------------
------------------------
------------------------
------------------------
------------------------
----------------------o-
----------------------o-
----------------------o-
----------------------D-
----------o-------------
C-S-S-C---o----------*--
----------o-------*--D--
ooo----------g--g-D--D--
XXXX-XXXXXXXXXXXXXXXXXX-
XXXX-XXXXXXXXXXXXXXXXXX-