-DD---------------------
--D---------------------
--D---------------------
--D---------------------
--D---------------------
--D---------------------
--D---------------------
--D----------D----------
--D---------------------
--DDDDDDDDDDDD----------
-----------D---X-------o
--o--------D---X-------o
--*----------o-Xo------o
--D----r-----*-Xo------g
XXXXXXXXXXXXXXXXX------X
XXXXXXXXXXXXXXXXX------X