------------------------
------------------------
------------------------
------------------------
------------------------
------------------------
------------------------
---------------D--------
X----------------XXX--XX
X-------o----D---XXX--XX
X-------o---------------
X-------o------DX-------
X-------o------DX-------
XD------r------D--------
XXXX----D----XXXXXXX--XX
XXXX---------XXXXXXX--XX