------------------------
------------------------
------------------------
------------------------
------------------------
------------------------
------------------------
------------------------
---o--o-----------------
---o--o-----------o----D
------------------o-----
---!--!-----------o-----
------------------o-----
--------g-gD------r-----
XXXXXXXXXXXXXX----D----X
XXXXXXXXXXXXXX---------X