------------------------
------------------------
------------------------
------------------------
--------oo--------------
---------------oX-------
---------------oX-------
--D------------XX-------
----XXX----XX--XX-------
D---XXX----XX--XX-------
------X---------X---o---
--DX--X---------X---o---
--DX--X---------X---o---
--D---X---------X------g
XXXXXXX---------X-XXXXXX
XXXXXXX---------X-XXXXXX