-----------D------------
-----------D------------
-----------D------------
-----------D------------
-----------D------------
-----------D------------
-----------D------------
-----------D------------
-----------D------------
-----------D------------
DDDDDDDDDDD---o---------
---oo---------o---------
--------------o-------*-
-y----y-----------k---D-
XXXXXXXXXXXXXXXXXXXXXXXX
XXXXXXXXXXXXXXXXXXXXXXXX