-----------D------------
-----------D------------
-----------D------------
-----------D------------
-----------D------------
-----------D-----------#
-----------D-----------#
-----------D-----------#
-----------D------------
-----------D------------
DDDDDDDDDDD-------------
---oo--------------oo---
---------------#---##---
-y----y-----X--#--y--y--
XXXXXXXXXXXXXXXXXXXXXXXX
XXXXXXXXXXXXXXXXXXXXXXXX