------------------------
------------------------
------------------------
------------------------
------------------------
------------------------
------------------------
-----------------------D
DDDDDD------------------
-----D----------o----D--
-----D--Y-------o-------
-------oo-------o------D
-------oo-------o------D
-XyXyX-ooD------r------D
-XXXXX-XXXXX----D----XXX
-XXXXX-XXXXX---------XXX