-------------D----------
-------------D----------
------g------D----------
-g--DDDDD----D----------
XX--DDDDD----D----------
XX--D---D----D----------
-X--D---D---oD----------
-X--D---D---oD----------
----D---D---oD----------
----D---D---oD----------
-DD-D---D---oD----------
-D--D---D---------------
-DD-D---D----------D----
--D-D---DTT--------D----
-DDXXXXXXttXXXXXXXXXXXXX
---XXXXXXttXXXXXXXXXXXXX