------------------------
------------------------
------------------------
------------------------
------------------------
------------------------
------------------------
--------------------D---
------------------------
o------------o----D-----
o------------o----------
o------------o------D---
-------------o------D-D-
D-gD-gD------r------D-D-
XXXXXXXXX----D----XXXXXX
XXXXXXXXX---------XXXXXX