------------------------
------------------------
------------------------
------------------------
------------------------
------------------------
------------------------
----------o-------------
----------D-------------
----------D-------------
-------------o----------
---------*---o----------
------*--D---o-------*--
--k---D--D------g--g-D--
XXXXXXXXXXXXXXXXXXXXXXXX
XXXXXXXXXXXXXXXXXXXXXXXX