------------------------
------------------------
------------------------
------------------o--o--
------------------------
------------------------
----------o-------#-----
----------o-----g##-----
----------o-----###-----
----------D---g####-----
--------------#####-----
---------*--g######-----
------*--D--#######-----
-g--g-D--D-########----#
XXXXXXXXXXXXXXXXXXXXXXXX
XXXXXXXXXXXXXXXXXXXXXXXX