----------------D-------
----------------D-------
----------------D-------
----------------D-------
----------------D-------
----------------D-------
----------------D-------
----------------D-------
X------o--o-----D-------
X------o--o-----D-------
X---------------DDDDDDDD
X------!--!----------oo-
X-----------------------
X-----------g-g-k--y----
XXXXXXXXXXXXXXXXXXXXXXXX
XXXXXXXXXXXXXXXXXXXXXXXX