------------------------
------------------------
------------------------
--gX-g------------------
XXXXXX------------------
XXXXXX------------------
-----X------------------
-----X------------------
-----------oooo-----g---
-------##--####--#####-X
-D-D-DD-#-y#--#-y#-----X
-D-D-D---##----##-------
-D-D-DD-----------------
--D---D-----------------
--D--DD-----------------
------------------------