-----------------------D
-----------------------D
-----------------------D
-----------------------D
-----------------------D
-----------------------D
---------------------o-D
---------------------o-D
---------------------o-D
---------------------D-D
---------o-------------D
---------o----------*---
-----D---o-------*--D---
-----D------g--g-D--D--k
XXXXXXXXXXXXXXXXXXXXXXXX
XXXXXXXXXXXXXXXXXXXXXXXX