-----------------------D
-----------------------D
-----------------------D
--gX-g-----------------D
XXXXXX-----------------D
XXXXXX-----------------D
-----X-----------------D
-----X------------------
-----------oooo-----g---
-------##--####--#####-X
-D-D-DD-#-y#--#-y#-----X
-D-D-D---##----##-------
-D-D-DD-----------------
--D---D-----------------
--D--DD-----------------
------------------------