---------------D--------
---------------D--------
---------------D--------
---------------D--------
---------------D*-------
---------------DD-------
----o----------D--------
---Xo-------------------
---Xo-------------k----k
XXXXXTTXXXXXX--XXXXXXXXX
XXXXXttXXXXXX--XXXXXXXXX
-----tt-----------------
-----tt-----------------
-----tt-----------------
-----tt-----------------
-----tt-----------------