------------D-----------
------------D-----------
------------D-----------
------------D-----------
------------D-----------
------------D-----------
------------D-----------
------------D-----------
------------D-----------
------------D-----------
------------DDDDDDDDDDDD
-----------------oo-----
---*-----D--------------
---D-----D--k--y----y---
XXXXXXXXXXXXXXXXXXXXXXXX
XXXXXXXXXXXXXXXXXXXXXXXX