------------------------
------------------------
------------------------
------------------------
------------------------
------------------------
---------------------o--
---------------------o--
--o------------------o--
--o------------------D-X
---------o-------------X
--!------o----------*---
---------o-------*--D---
----g-g-----g--g-D--D---
XXXXXXXXXXXXXXXXXXXXXX--
XXXXXXXXXXXXXXXXXXXXXX--