---------------------D--
---------------------D--
---------------------D--
---------------------D--
---------------------D--
---------------------D--
---------------------D--
---------------------D--
DD-------------------D--
-D-----------o-------D--
-D--Y--------o-------DDD
---oo--------o----------
---oo--------o----------
yX-oo--------o-------k--
XX-XXX-------X-----XXXXX
XX-XXX-------X-----XXXXX