--D------------D--------
--D------------D--------
--D------------D--------
--D------------D--------
--D------------D--------
--D------------D--------
--D------------D--------
--D------------D--------
--D------------D--------
--D------------D--------
--DDDDDDDDDDDDD-------TT
-------oo------------ott
---------------------ott
--k--y----y-----X-X--ott
XXXXXXXXXXXXXXXXXXXXXXXX
XXXXXXXXXXXXXXXXXXXXXXXX