------------------------
------------------------
------------------------
------------------------
------------------------
------------------------
------------------------
------------------------
------------------------
-------o----------------
-------o-------------TTo
----o--o--o----------tto
---o-------o---------tto
-------r-------------ttg
X------X-----TTXXXXXXXXX
X------X-----ttXXXXXXXXX