--D------------D--------
--D------------D--------
--D------------D--------
--D------------D--------
--D------------D--------
X-D------------D--------
X-D------------D--------
X-D------------D--------
X-D------------D------o-
X-D------------D-----o-o
X-DDDDDDDDDDDDD-----o-o-
X------oo----------o-o-o
X---------------D-----|-
X-k--y----y-----X-k---|-
XXXXXXXXXXXXXXXXXXXXXXXX
XXXXXXXXXXXXXXXXXXXXXXXX