------------------------
------------------------
------------------------
------------------------
D--------------g--------
-------------DDD--------
-----------TTDD---------
-----------tt-----------
-----g-g---tt---------o-
-XXXXXXXTTXXXXXX-----o-o
-XXXXXXXttXXXXXX----o-o-
--------tt------K--o-o-o
--------tt------D---D---
--------tt--------D---D-
--------tt------XXXXXXXX
--------tt------XXXXXXXX