D-D------------D-D------
D-D------------D-D------
D-D------------D-D------
D-D------------D-D------
D-D------------D-D------
D-D------------D-D------
D-D------------D-D------
D-D------------D-D------
D-D------------D-D------
D-D------------D-D------
--DDDDDDDDDDDDD--DDDDDDD
-------oo-------------oo
------------------------
--k--y----y------k--y---
XXXXXXXXXXXXXXXXXXXXXXXX
XXXXXXXXXXXXXXXXXXXXXXXX