-----D------------D-----
-----D------------D-----
-----D------------D-----
-----D------------D-----
-----D------------D-----
-----D------------D-----
---o-D------------D-----
---o-D------------D-----
---o-D------------D-----
---D-D------------D-----
-----DDDDDDDDDDDDD------
--*-------oo-----------D
--D-------------------D-
--D--k--y----y-------D--
XXXXXXXXXXXXXXXXXXXXXXXX
XXXXXXXXXXXXXXXXXXXXXXXX