------------------------
------------------------
------------------------
------------------------
------------------------
------------------------
------------o-----o-----
------------o----Xo-----
------------o----Xo-----
------------D-XXXXXTTXXX
o-------------XXXXXttXXX
o----------*-------tt---
o-------*--D-------tt---
---g--g-D--D-------tt---
XXXXXXXXXXXXX------tt---
XXXXXXXXXXXXX------tt---