------------------------
------------------------
------------------------
------------------------
------------------------
------------------------
------------------------
------------------------
----o-------------------
---o-o---------------o--
--o-o-o--------------o--
-o-o-o-o--K----------o--
--D---D---D----------o--
D---D---D------------o--
XXXXXXXXXXXXXX-------X--
XXXXXXXXXXXXXX-------X--