-------D------------D---
-------D------------D---
-------D------------D---
-------DD----*----DD----
-----g-------D----------
---DDD-------D----------
-TTDD--XXXXXXXXXXXXX----
-tt---------------------
-tt---------------------
XXXXXX------------------
XXXXXX-----------------o
-----------------------o
-----------------------o
------------------------
---------------------XXX
---------------------XXX