------------------------
------------------------
------------------------
------------------------
------------------------
------------------------
------------------------
------------------------
------------------------
------------------------
----------------TT-----X
---------------otto-----
--*-----D------otto-----
--D-----D-X-X--otto--X-X
XXXXXXXXXXXXXXXXXXXXXXXX
XXXXXXXXXXXXXXXXXXXXXXXX