------------DD----------
-------------D----------
-------------D----------
-------------D----------
--oo---------D----------
---------oX--D----------
---------oX--D----------
---------XX--D----------
X----XX--XX--D----------
X----XX--XX--DDDDDDDDDDD
X---------X-----------D-
X---------X--o--------D-
X---------X--*----------
X---------X--D----r-----
X---------X-XXXXXXXXXXXX
X---------X-XXXXXXXXXXXX