-----------D------------
-----------D------------
-----------D------------
----#-----oD------------
--###-----oD------------
X-----#--y--------------
X-----#####-------------
X-----------------------
X---------#g-g----------
X---------######--------
X-----------------------
X-----------------------
X-----------------------
X-----------------------
X---------------X-------
X---------------X-------