------------------------
------------------------
------------------------
------------------------
------------------------
--D---------------------
-----------------o------
-----------------o------
-----------------o------
-----------------DDD---o
-----o-----------------T
-----o----------*------t
-----o-------*--D------t
--------g--g-D--D------t
XXXXXXXXXXXXXXXXXX-----t
XXXXXXXXXXXXXXXXXX-----t