----------------------DD
------------------------
------------------------
------------------------
------------oo----------
----oX-------------oX--X
----oX-------------oX--X
----XX-------------XX--X
XX--XX--XXX----XX--XX--X
XX--XX--XXX----XX--XX--X
-----X----X---------X--X
-----X-X--X---------X--X
-----X-X--X---------X--X
-----X----X---------X--X
-----X-XXXX---------X--X
-----X-XXXX---------X--X