-----------------------
-----------------------
-----------------------
-----------------o-----
----------------o------
---------------o-------
-o-------------#-------
o-o-----------##-------
-o-o----------##-------
DDDDDDD----o--##-------
-----------#--##-------
----------##--##-------
T---------##--##-------
t-------#-##--##----#--
t---TT--X-XX--XXXXXXXXX
t---tt--X-XX--XXXXXXXXX