------------------------
------------------------
----!--!----------------
------------------------
------------------------
----!--!--------------#-
----------------------#-
----------------------#-
XoXXoXXoXX--------------
XXXXXXXXXX--------------
XXXXXXXX----------------
XXXXX-------------oo----
XX------------#---##---#
-----------X--#--y--y--#
-----------XXXXXXXXXXXXX
-----------XXXXXXXXXXXXX