--------DD--------------
---------D--------------
---------D--------------
---------D--------------
---------D--------------
---------D--------------
-o-------D--------------
o-o------D----------D---
-o-o-----D--------------
DDDDDDD--DDDDDDDDDDDD---
------------------D---X-
---------o--------D---X-
T--------*----------o-X-
t--------D----r-----*-X-
t---TT--XXXXXXXXXXXXXXX-
t---tt--XXXXXXXXXXXXXXX-