-------D---------------
-------D---------------
-------D---------------
-------D---------------
-------D---------------
-------D-------o-------
-------D-------#-------
-------D------##-------
-------D----o-##-------
-------D----#-##-------
DDDDDDD----##-##-------
o---------###-##-------
--------o-###-##-------
--y-----#-###-##g--g#--
XXXXXXXXX-XXX-XXXXXXXXX
XXXXXXXXX-XXX-XXXXXXXXX