------------------------
------------------------
------------------------
------------------------
------------------------
------------------------
-----------------o------
-----------------o------
%%%--------------o------
%%%--------------D------
-----o------------------
-----o----------*-------
-----o-------*--D-------
--------g--g-D--D-------
---XXXXXXXXXXXXXXXXXXXXX
---XXXXXXXXXXXXXXXXXXXXX