----------------------DD
-----L-----------------D
-----------------------D
----K------------------D
-%%%%%-----------------D
-%%%%%-----------------D
---||------------------D
---||----------------D-D
%%%%%%-----------------D
%%%%%%--------o----D---D
|-------------o---------
|-------------o------D-o
|-------------o------D-*
|------D------r------D-D
|------XXX----D----XXXXX
|------XXX---------XXXXX