-------D----------------
-------D----------------
-------D----------------
-------D----------------
-------D----------------
-------D----------------
-------D----------------
-------D----------------
-------D------o---------
-------D-----o-o--------
DDDDDDD-----o-o-o-------
o-------K--o-o-o-o--K---
--------D---D---D---D---
--y-------D---D---D-----
XXXXXXXXXXXXXXXXXXXXXXXX
XXXXXXXXXXXXXXXXXXXXXXXX