------------------------
------------------------
------------------------
------------------------
------------------------
------------------------
----------------##------
----------------##------
--------------#-##------
--------------#-##------
------------#-#-##------
------------#-#-##------
-----TT---#-#-#-##------
-----TT---#-#-#-##------
XXXXXXXXX-X-X-X-XXXXXXXX
XXXXXXXXX-X-X-X-XXXXXXXX