------------------------
------------------------
------------------------
------------------------
------------------------
------------------------
SS--------SSCSS------SSS
------------------------
------------------------
------------------------
---TT---QQQQ--QQQ-------
---TT-------------------
---TT-------------------
---TT------------ggg----
XXXXXXXXXXXXXXXXXXXXX---
XXXXXXXXXXXXXXXXXXXXX---