------------------------
------------------------
------------------------
------------------------
------------------------
------------k-----------
-----------##-----------
----------###-----------
--------k####-----------
--------#####-----------
-------######-----------
------#######-----------
-----########-----------
----#########--------#--
XXXXXXXXXXXXXXXXXXXXXXXX
XXXXXXXXXXXXXXXXXXXXXXXX