------------------------
------------------------
------------------------
------------------------
------------------------
------------------------
------------------------
------------------------
------------------------
----------oo---oo-------
------------------------
------------------------
-#----------------------
-#----------------------
XXXXXXXX-----X----XXXXXX
XXXXXXXX-----X----XXXXXX