------------------------
------------------------
------------------------
------------------------
------------------------
------------------------
------------2-----------
------------------------
------------------------
----ooo-----------------
------------2-----------
-TT--------------------#
-TT-------------------##
-TT-------y--y-------###
XXXXXXXXXXXXXXXXXXXXXXXX
XXXXXXXXXXXXXXXXXXXXXXXX