------------------------
------------------------
------------------------
------------------------
-----------------------o
----------------------o-
----------------------#-
-------------o-------##-
-X-----------2X------##-
-X------------X---o--##-
-X-----------oX---#--##-
-X-----------2X--##--##-
-X------------X--##--##-
-X-r-----r----X#-##--##-
XXXX--XX-XX-XXXX-XX--XXX
XXXX--XX-XX-XXXX-XX--XXX