---------------------D--
---------------------D--
---------------------D--
---------------------D--
---------------------D--
-------------------D-D--
----D----------------D--
---YD----------------D--
---DD----------TT----D--
----D----------tt----DDD
g-g-D------TToott-------
DDDDD------ttoott-------
----D------ttoott-------
----D------ttggtt-------
XXXXXXXXXXXXXXXXXXXX--TT
XXXXXXXXXXXXXXXXXXXXX-tt