------D------------D----
------D------------D----
------D------------D----
------D------------D----
------D------------D----
------D------------D----
----D-D------------D----
---YD-D------------D----
---DD-D------------D----
----D-D------------D----
g-g-D-DDDDDDDDDDDDD-----
DDDDD------oo-----------
----D------------------D
----D-k--y----y-------D-
XXXXXXXXXXXXXXXXXXXXXXXX
XXXXXXXXXXXXXXXXXXXXXXXX