------------------------
------------------------
------------------------
------------------------
------------##----------
------------##----------
--------C---##----------
------------##----------
------------##----------
------------##----------
-------SS---##----------
------------##----------
------------##--------F-
--------k---##--------X-
XXXXXXXXXXXXXXXXXXXXXXXX
XXXXXXXXXXXXXXXXXXXXXXXX