-----------------------
-----------------------
-----------------------
-----------------------
-----------------------
-----------------------
-1-------USS-----------
-----------------------
-----------------------
-ggg-------------------
#####---#-------------T
----#---#-------------T
----#---##------------T
----#---##--gg----k---T
----X---XXXXXXXXXXXXXXX
----X---XXXXXXXXXXXXXXX