------------------------
------------------------
------------------------
------------------------
---o--------------------
--%%%-------------------
---|--o------o--o---SSS-
---|--SSSS--------------
%--|--------------------
---|---------SSSS-------
---|------------------%%
---|-------------------|
---|-----%%%%----------|
---|------||-----------|
%%%%%%----||-----------|
|||||-----||-----------|