------------------------
------------------------
------------------------
------------------------
------------------------
------------------------
------------------------
------------------------
------------------------
------------------------
-----------------------C
----------------#-------
------------K---#-------
----------------#-----gg
X---XXXXXXXXXX--XXXXXXXX
X---XXXXXXXXXX--XXXXXXXX