------------------------
------------------------
------------------------
--------------------ooo-
--------------------%%%-
---------------------|--
------SSoo----SS-----|--
---------------------|--
---------------------|--
---------------------|--
%%%%%%----SS-----SS--|--
-||||---------------%%%%
-||||----------------|||
-||||----------------|||
-||||----------------|||
-||||----------------|||