-----------------------
-----------------------
-----------------------
-----------------------
-----------------------
-----------------------
----------------------S
-----------------------
---*-------------------
---*-------------------
-SS#CS---------------SS
---------------TT------
-------*-------TT------
-------*-------TT------
XXXXXXXXXXXX--XXXXXXXXX
XXXXXXXXXXXX--XXXXXXXXX