-----------------------
-----------------------
-----------------------
-----------------------
-----------------------
---------------SSS-----
-----------------------
-------------g---------
---------%%%%%%--------
----------||||----SSS--
----------||||---------
-----%%%%%||||---------
------|||-||||---------
------|||-||||----oo---
XXX---|||-||||---%%%---
XXX---|||-||||----|----