-----------------------
-----------------------
-----------------------
SSS-----SSSSSSSSSSSSSSS
--------SSSSSSSSSSSSSSS
--------SSSSSSSSSSSSSSS
--------SSSSSSSSSSSSSSS
--------S--------------
--------S--------------
----------oooooooooo---
---------USSSSSSSSSS---
--#--------------------
-##-SSS---------------#
###-------------kk---##
XXX-----XXXXXXXXXXXXXXX
XXX-----XXXXXXXXXXXXXXX