------------------------
------------------------
------------------------
------------------------
------------------------
------------------------
------------------------
------------------------
------------------------
------------------------
-----TT-----------------
-----TT-----------------
-----TT-----------------
-ggg-TT----k-k----------
XXXXXXXXXXXXXXXX-X-XX-XX
XXXXXXXXXXXXXXXX-X-XX-XX