-----------------------
-----------------------
-----------------------
-------SSSS-----SSSSSSS
-----------------------
-----------------------
-------SUS-------------
-----------------------
---SSS------SSS--------
-----------------------
-------SSSS------------
#----------------------
#------------------tt--
#------------------tt--
X------XXXX------XXXXXX
X------XXXX------XXXXXX