-----------------------
-----------------------
-----------------------
-----------------------
-----------------------
-----------------------
-----------------------
-----------------------
-----------------------
-----------------------
-----------------------
-----------------------
----TT-----------------
----TT-----------------
XXXXXXXXXXXXXXX---XXX--
XXXXXXXXXXXXXXX---XXX--