-----------------------
-----------------------
-----------------------
-----------------------
-----------------------
-----------------------
--------2--------------
-----------------------
---------------------y-
ooo------------------#S
--------2-----------##-
-------------------###-
------------------####-
------y--y-------#####-
XXXXXXXXXXXXXXXXXXXXXX-
XXXXXXXXXXXXXXXXXXXXXX-