-----------------------
-----------------------
-----------------------
-----------------------
-----------------------
-----------------------
-----------------------
-----------------------
-----------------------
---------------------SS
#----------------------
#-------K--------------
#-----------K----------
#----------------------
XXXXXX-X-XX-X-XX-XXXXXX
XXXXXX-X-XX-X-XX-XXXXXX