------------------------
------------------------
------------------------
------------------------
------------------------
---R------------------oo
---------g----oo--------
-----%%%%%%-------------
------||||--------------
------||||-----SSS------
%%----||||-------------S
|-----||||--------------
|-----||||--------------
|-----||||--------------
|-----||||--------------
|-----||||--------------