------------------------
------------------------
------------------------
------------------------
------------------------
------------------------
-----------------------S
------------------------
------------------------
------------------------
-----------------------S
------------------------
----TT-----*-----TT-----
-k--TT-----*-----TT-----
XXXXXXXXXXXXXXXXXXXXXXXX
XXXXXXXXXXXXXXXXXXXXXXXX