-----------------------
-----------------------
-----------------------
-----------------------
-----------------------
-oooo----------R-------
-%%%%----------------g-
--||-------------%%%%%%
--||--------------||||-
--||--------------||||-
--||-------%%%----||||-
U-||--------|-----||||-
--||--------|-----||||-
--||--------|-----||||-
%%%%%-%%%%%-|-----||||-
-|||---|||--|-----||||-