-----------------------
-----------------------
-----------------------
-----------------------
-----------------------
-----------------------
----------R-----oo-----
------r----------------
%%%%%%%%---------------
-||||||----------------
-||||||-----%%%%--%%%%-
-||||||------||----||--
-||||||------||----||--
-||||||--ooo-||----||--
-||||||--%%%-||----||--
-||||||---|--||----||--