-----------------------
-----------------------
-----------------------
-----------------------
-----------------------
-----------------------
------------------Q----
-----------------------
-----------------------
-----------------------
------------------?----
--------------TT-------
--------------TT-------
-M------------TT-------
XXXXXXXXXXXXXXXXXXXXXXX
XXXXXXXXXXXXXXXXXXXXXXX