-----------------------
-----------------------
-----------------------
-----------------------
-----------------------
-----------------------
SSSCSSS----------------
-----------------------
-----------------------
-----------------------
---2----#--------------
-----K--#-------K------
--------#-----------K--
--------#--------------
XXXXXXXXXXXXXX-X-XX-X-X
XXXXXXXXXXXXXX-X-XX-X-X