-----------------------
-----------------------
-----------------------
-----------------------
----------------oo-----
-----------------------
------------------%%%%-
-----------SSS-----||--
---SSS-oo----------||--
-------------------||--
%%-----SS----------||--
|------------------||--
|------------------||--
|------------------||--
|------------------||-X
|------------------||-X