-----------------------
-----------------------
-----------------------
-----------------------
-----------------------
-----------------------
S----------------------
-----------------------
------------------#----
------------k-----#----
S--------SCSSS----#----
-----------K-----##----
-----------------##----
g--------K---K---##----
XXXXXXXXXXXXXXXXXXX---X
XXXXXXXXXXXXXXXXXXX---X