-----------------------
-----------------------
-----------------------
-----------------------
-----------------------
-----------------------
--------------SSSSS---?
-----------------------
-----------------------
-----------------------
-----------C--------Q--
----#------------------
K---#------------------
----#-----gg-------K-K-
XX--XXXXXXXXXXXXXXXXXXX
XX--XXXXXXXXXXXXXXXXXXX