-----------------------
-----------------------
-----------------------
SSSSSSSSSSSSSSSSSSSSSSS
------------------SS--S
------------------SS--S
-----oooo-------SS-----
----------------SS-----
---S-SSSS-U-----SS-----
---SoS--SoS-----SS----o
---SSS--SSS-----SSSS--S
------------------SS---
------------------SS---
------kk---------------
XXXXXXXXXXXXXXXXXXXXXXX
XXXXXXXXXXXXXXXXXXXXXXX