------------------------
------------------------
------------------------
SSSSSSSSSSSSSSSSS-------
SSSSSSSS----------------
SSSCSSSS----------------
SSSSSSSS--QQ------------
------------------------
-------------------SSS--
---ggg-----------------2
SSSSSSSS--QQ--QQQ-------
SSSSSSSS----------------
SSSSSSSS----------------
SSSSSSSS----------------
XXXXXXXXXXXXXXXXX------X
XXXXXXXXXXXXXXXXX------X