------------------------
------------------------
------------------------
------------------------
------------------------
-------------------SSS--
------------------------
-----------------g------
-------------%%%%%%-----
--------------||||----SS
--------------||||------
---------%%%%%||||------
----------|||-||||------
----------|||-||||----oo
XXXXXXX---|||-||||---%%%
XXXXXXX---|||-||||----|-