-----------------------
-----------------------
-----------------------
-----------------------
-----------------------
-----------------------
----USSS---------------
-----------------------
-----------------------
--E------TT------------
-TT------TT------------
-TT--tt--TT------------
-TT--tt--TT------------
-TT--tt--TT-----k------
XXXXXXXXXXXXXXXXXX---XX
XXXXXXXXXXXXXXXXXX---XX