-----------------------
-----------------------
-----------------------
-----------------------
-----------------------
--------------ooor-----
-------------%%%%%-----
--------------|||------
--------------|||------
--------------|||-----%
-----------%%%%%%%%----
------------||||||-----
------------||||||--o--
-----%%%%---||||||-%%%-
XXX---||----||||||--|--
XXX---||----||||||--|--