-----------------------
-----------------------
-----------------------
SSSSSSSSSSSSSSSSSSSSSSS
SSSSSSSSSSSSSSSS-------
SSSSSSSSSSSCSSSS-------
SSSSSSSSSSSSSSSS--QQ---
-----------------------
-----------------------
-----------ggg---------
SSSSSSSSSSSSSSSS--QQ--Q
SSSSSSSSSSSSSSSS-------
SSSSSSSSSSSSSSSS-------
SSSSSSSSSSSSSSSS-------
XXXXXXXXXXXXXXXXXXXXXXX
XXXXXXXXXXXXXXXXXXXXXXX