------------------------
------------------------
------------------------
------------------------
------------------------
------------------------
----D-------------------
---YD-------------------
---DD----oooo-----g-----
----D##--####--#####----
g-g-D-#-y#--#-y#--------
DDDDD--##----##---------
----D-------------------
----D-------------------
XXXXX---------------XXXX
XXXXX---------------XXXX