------D-----------------
------D-----------------
------D-----------------
------D-----------------
------D-----------------
------D-----------------
------D-----------------
------D--------------o--
------D--------------D--
------D--------------D-D
DDDDDD---o--------------
---------o----------*---
---------o-------*--D---
-y-----------k---D--D---
XXXXXXXXXXXXXXXXXXXXXX--
XXXXXXXXXXXXXXXXXXXXXX--