-----------D------------
--------L--D------------
-----------D------------
-------K---D------------
----%%%%%--D------------
----%%%%%--D------------
------||---D------------
--k---||---D------------
%%%%%%%%%--D------------
%%%%%%%%%--D------------
--||-------DDDDDDDDDDDDD
--||------------oo------
--||--------------------
--||-------k--y----y----
--||------XXXXXXXXXXXXXX
--||------XXXXXXXXXXXXXX