------------------------
------------------------
------------------------
------------------------
------------------------
------------------------
------------------------
------------------------
---o---------------D----
--o-o---------SSS@SSSS--
-o-o-o---------------S--
o-o-o-o---------------SS
---|-------D--oo-------o
---|----k--X--oo--g----o
XXXXXXXXXXXXXXXXXXXXXXXX
XXXXXXXXXXXXXXXXXXXXXXXX