------------------------
------------------------
------------------------
------------------------
------------------------
------------------------
------------------------
------------------------
------------------------
--------------------o---
--------------------o---
----C-S-S-C---------o---
--------------------o---
----ooo-------------o---
X--XXXXX-XXXX-------X---
X--XXXXX-XXXX-------X---