------------------------
------------------------
--------!--!------------
------------------------
------------------------
--------!--!------------
------------------------
-------------k----------
XXXXXXXXXXXXXX----------
XXXXXXXXXXXXXX----------
------------------------
------------------------
----------------D-----*-
----------------D-----D-
---------------XXXXXXXXX
---------------XXXXXXXXX