------------D-----------
------------D-----------
------------D-----------
------------D-----------
------------D-----------
------------D-----------
------------D-----------
------------D-----------
------------D----------T
------------D----------t
DDDDDDDDDDDD-------TToot
----oo-------------ttoot
-------------------ttoot
--y----y-----------ttggt
XXXXXXXXXXXXXXXXXXXXXXXX
XXXXXXXXXXXXXXXXXXXXXXXX