------------------------
-----------------L------
------------------------
----------------K-------
-------------%%%%%------
-------------%%%%%------
---o-----------||-------
---o---k---k---||-------
---o-%%%%%%%%%%%%%------
---D-%%%%%%%%%%%%%------
-----------||--------o--
--*--------||--------o--
--D--------||--------o--
--D--------||-----------
XXXX-------||------XXXXX
XXXX-------||------XXXXX