------------------------
------------------------
#-----------------------
#-----------------------
------------------------
------------------------
------------------------
------------------------
#-----------------------
#-----------------------
#-----------------------
#-------C-S-S-C-----DDDD
#------------------D----
#-------ooo-------D-----
XXXXX--XXXXX-XXXXXXXXXXX
XXXXX--XXXXX-XXXXXXXXXXX