------------------------
------------------------
------------------------
------------------------
------------------------
------------------------
------------------------
------------------------
------------------------
------------------------
--------------o---------
----C-S-S-C---o---------
--------------o-------*-
----ooo-----------k---D-
X--XXXXX-XXXXXXXXXXXXXXX
X--XXXXX-XXXXXXXXXXXXXXX