------------------------
------------------------
------------------------
------------------------
------------------------
------------------------
------------------------
------------D-----------
------------------------
-----o----D-------------
-----o------------------
-----o------D-----------
-----o------D-D-----*---
-----r------D-D-----D---
X----D----XXXXXXXXXXXXXX
X---------XXXXXXXXXXXXXX