------------------------
------------------------
------------------------
------------------------
------------------------
------------------------
------------------------
------------------------
---D-------------o------
S@SSSS---D------o-o-----
---------D-----o-o-o----
------SSSD----o-o-o-o---
-------ooD-D-----|------
--g----ooD-X-k---|----k-
XXXXXXXXXXXXXXXXXXXXXXXX
XXXXXXXXXXXXXXXXXXXXXXXX