------------------------
------------------------
------------------------
------------------------
------------------------
------------------------
------------------------
-----------------------Y
-o---------------------D
o-o---------------------
-o-o--------------g-g-g-
o-o-o---------DDDDDDDDDD
-|-------D---D----------
-|----k--X--D-----------
XXXXXXXXXXXXXXXXXXXXXXXX
XXXXXXXXXXXXXXXXXXXXXXXX