------------------------
------------------------
------------------------
------------------------
------------------------
--------------------o---
------o-------------#---
-----o-o-----------##---
----o-o-o--------o-##---
DDDDDDDDDDDD-----#-##---
----------------##-##---
---------------###-##---
----TT-------o-###-##---
----tt-------#-###-##g--
TT--tt---TT--X-XXX-XXXXX
tt--tt---tt--X-XXX-XXXXX