--D---------D-----------
--D---------D-----------
--D---------D-----------
--D---------D-----------
--D---------D-----------
--D---------D-----------
--D---------D-----------
--D---------D-----------
--D---------D-----------
--DDDDDDDDDDD-----------
------------------------
----------------------oo
------ooo---oo----#---##
-------y--Y--y-X--#--y--
XXXXXXXXXXXXXXXXXXXXXXXX
XXXXXXXXXXXXXXXXXXXXXXXX