------------------------
------------------------
------------------------
------------------------
D-----------------------
D-----------------------
------------------------
-D----------------------
---------D--------------
----SSS@SSSS---D--------
-----------S---D--------
------------SSSD--------
----oo-------ooD--------
----oo--g----ooD-D------
--XXXXXXXXXXXXXXXXXX----
--XXXXXXXXXXXXXXXXXX----