-U----------------------
------------------------
-D----------------------
---D--------------------
-D----------------------
---D--------------------
-D----------------------
--g---------------------
DDDD--------------------
----D-------------o----D
-----D------------o-----
oo----D-----------o-----
-o-----D----------o-----
oo------D--D------r-----
---------XXXXX----D----X
---------XXXXX---------X