------------------------
------------------------
------------------------
------------------------
------------------------
------------------------
------------------------
-k----------------------
XX----------------------
XX----------------------
------------------------
------------------------
----D-----*-----D-------
----D-----D-----D-------
---XXXXXXXXXXXXXXXXXXXXX
---XXXXXXXXXXXXXXXXXXXXX