------------------------
------------------------
------------------------
------------------------
------------------------
------------------------
------------------------
------------------------
-----------D------------
DDD---SSS@SSSS---D------
-----------------D------
--------------SSSD------
------oo-------ooD------
------oo--g----ooD------
TT--XXXXXXXXXXXXXXXXXXXX
tt--XXXXXXXXXXXXXXXXXXXX