------------------------
------------------------
------------------------
------------------------
------------------------
------------------------
------------------------
------------------------
------------------------
------------------------
------------------------
------------------------
------------------------
------------------------
D--y---D-------D--y---D-
-TTXXTT--XXXX---TTXXTT--