-------------U----------
------------------------
-------------D----------
---------------D--------
-------------D----------
---------------D--------
-------------D----------
----------r------r------
-----g-%%%%%%%%%%%%%%%--
--#####%%%%%%%%%%%%%%%--
-y#-----------||--------
##------------||--------
--------------||--------
--------------||--------
--------------||------XX
--------------||------XX