------------------------
------------------------
!--!--------------------
------------------------
------------------------
!--!--------------------
------------------------
------------------------
oXXoXX-----oooo-----g--X
XXXXXX-##--####--#####-X
XXXX----#-y#--#-y#------
X--------##----##-----X-
----------------------X-
------------------------
----------------------XX
----------------------XX