--D---------D-----------
--D---------D-----------
--D---------D-----------
--D---------D-----------
--D---------D-----------
--D---------D-----------
--D---------D-----------
--D---------D-----------
--D---------D-----------
--DDDDDDDDDDD-----------
-----------------------g
-------------------DDDDD
------ooo---oo----D-----
-------y--Y--y---D------
XXXXXXXXXXXXXXXXXXXXXXXX
XXXXXXXXXXXXXXXXXXXXXXXX