-----D------------D-D---
-----D------------D-D---
-----D------------D-D---
-----D------------D-D---
-----D------------D-D---
-----D------------D-D---
-----D------------D-D---
-----D------------D-D---
-----D------------D-D---
--D--D------------D-D---
--D--DDDDDDDDDDDDD--DDDD
SSD-------oo------------
ooD---------------------
ooD--k--y----y------k--y
XXXXXXXXXXXXXXXXXXXXXXXX
XXXXXXXXXXXXXXXXXXXXXXXX