----D-D-----------------
----D-D-----------------
----D-D-----------------
----D-D-----------------
----D-D-----------------
----D-D-----------------
----D-D-----------------
----D-D-----------------
----D-DDDDDDDDDDD-------
----D-------------------
DDDD--------------------
----------o--------Y----
----------o--------Y----
----------o-----Dy-D----
XXXXXX----X-----XXXXX---
XXXXXX----X-----XXXXX---