--U---------------------
------------------------
--D---------------------
----D-------------------
--D---------------------
----D-------------------
--D---------------------
------r-----------------
%%%%%%%%%%%-------------
%%%%%%%%%%%-------------
---||--------o----------
---||--------o----------
---||--------o-------*--
---||-----------g--g-D--
---||------XXXXXXXXXXXXX
---||------XXXXXXXXXXXXX