----D------------D------
----D------------D------
----D------------D------
----D------------D------
----D------------D------
----D------------D------
----D------------D------
----D------------D------
----D------------D------
----D------------D--SSS@
----DDDDDDDDDDDDD-------
---------oo-------------
-D------------------oo--
-D--k--y----y-------oo--
XXXXXXXXXXXXXXXXXXXXXXXX
XXXXXXXXXXXXXXXXXXXXXXXX