-------------------D----
-------------------D----
-------------------D----
-------------------D----
-------------------D----
-------------------D----
-------------------D----
-------------------D----
-------------------DDDDD
-----------o------------
-----------o------------
X----------o-----------o
X----------o-----------o
X----------o-----------o
XXXX-------X-----XX----X
XXXX-------X-----XX----X