------------------------
------------------------
------------------------
------------------------
------------------------
------------------------
------------------------
------------------------
---------------o--------
--------------o-o-------
-------------o-o-o------
-C-S-S-C----o-o-o-o-----
---------D-----|-------D
-ooo-----X-k---|----k--X
XXXXX-XXXXXXXXXXXXXXXXXX
XXXXX-XXXXXXXXXXXXXXXXXX