---------D--------------
---------D--------------
---------D--------------
---------D--------------
---------D--------------
X--XXXX--D--------------
X--XXXX--Dg-g-----------
X--DX-----DDDDD---------
X--D*-------------------
X--DX-------------------
X--DX*---------D--------
X--DX------ooooD--------
X--D*------ooooD--------
X-DDDDDDDDDDDDDDDD------
X----------------XXX----
X----------------XXX----