D------------D----------
D------------D----------
D------------D----------
D------------D----------
D------------D----------
D------------D----------
D*-----------D----------
-------------D----------
X*-----------D----------
XX*------k---D-------o--
XXXXXXXXXXXXo--------o--
-----------Xo--------o--
-----------Xo--------o--
-----------Xo-D------r--
-----------XXXXXX----D--
-----------XXXXXX-------