------------------------
------------------------
------------------------
------------------------
------------------------
------------------------
------------------------
------------------------
-g----------------------
###--------------------o
----------------------o-
---------------------o-o
----D-----*-----D-D-----
----D-----D-----D-X-k---
---XXXXXXXXXXXXXXXXXXXXX
---XXXXXXXXXXXXXXXXXXXXX