------------------------
------------------------
----!--!----------------
------------------------
------------------------
----!--!----------------
------------------------
------------------------
XoXXoXXoXX--------------
XXXXXXXXXX--------------
XXXXXXXX----------------
XXXXX-------------------
XX----------D-----*-----
------------D-----D-----
-----------XXXXXXXXXXXXX
-----------XXXXXXXXXXXXX