------------------------
------------------------
------------------------
------------------------
------------------------
------------------------
------------------------
------------------------
------------------------
------------------------
------------------o-----
--------C-S-S-C---o-----
------------------o-----
--------ooo-----------k-
XXXXX--XXXXX-XXXXXXXXXXX
XXXXX--XXXXX-XXXXXXXXXXX