-----D---------D--------
-----D---------D--------
-----D---------D--------
-----D---------D--------
-----D---------D--------
-----D---------D--------
-----D---------D--------
--D--D---------D--------
-----D---------D--------
D----DDDDDDDDDDD--------
------------------------
--D-------------------DD
--D------ooo---oo----D--
--D-------y--Y--y---D---
XXXXXXXXXXXXXXXXXXXXXXXX
XXXXXXXXXXXXXXXXXXXXXXXX