----D------------D------
----D------------D------
----D------------D------
----D------------D------
----D------------D------
----D------------D------
----D------------D------
----D------------D------
----D------------D------
----D------------D------
----DDDDDDDDDDDDD-------
---------oo-----------DD
-D-------------------D--
-D--k--y----y-------D---
XXXXXXXXXXXXXXXXXXXXXXXX
XXXXXXXXXXXXXXXXXXXXXXXX