------------------------
------------------------
------------------------
------------------o--o--
------------------------
------------------------
------------------#-----
----------------g##-----
DDDDDDDDDDD-----###-----
---------D----g####-----
---------*----#####-----
------------g######-----
ooooooooo*X-#######-----
y--y--y---X########----#
XXXXXXXXXXXXXXXXXXXXXXXX
XXXXXXXXXXXXXXXXXXXXXXXX