-------------D----------
-------------D----------
-------------D----------
-------------D----------
-------------D----------
-------------D----------
-------------D----------
-------------D----------
DDDDDDDDD----DDDDDDDDDDD
-----------------------D
-----------------------D
--o--------Y------------
--o--------Y------------
--o-----Dy-D---XyX-XyXyX
--X-----XXXXX--XXX-XXXXX
--X-----XXXXX--XXX-XXXXX