-------------------
-------------------
-------------------
-------------o-----
------------o------
-----------o-------
-----------#-------
----------##-------
-TT-------##-------
DDD----o--##-------
-------#--##-------
------##--##-------
------##--##-------
----#-##--##----#--
----X-XX--XXXXXXXXX
----X-XX--XXXXXXXXX