---DD-------------------
---DD-------------------
---DD-------------------
---DD-------------------
---DD-------------------
---DD-------------------
---DD-------------------
---DD-------------------
---DD-------------------
---DD----XX---------o---
---DD----XX---------o---
---------D----------o---
--------*D----------o---
--oooo--D-----------o---
DDDDDDDD----X-------X---
------------X-------X---