-------D----------------
-------D----------------
-------D----------------
-------D----------------
-------D----------------
-------D----------------
-------D----------------
-------D----------------
-------D------o---------
-------D-----o-o--------
DDDDDDD-----o-o-o-------
o----------o-o-o-o------
--------D-----|-------D-
--y-----X-k---|----k--X-
XXXXXXXXXXXXXXXXXXXXXXXX
XXXXXXXXXXXXXXXXXXXXXXXX