----------------D-------
----------------D-------
----------------D-------
----------------D-------
----------------D-------
----------------D-------
----------------D-------
----------------D-------
----------------D-------
--------o-------D-------
--------o-------DDDDDDDD
--------o------------oo-
--------o---------------
--------o-------k--y----
X-------X-----XXXXXXXXXX
X-------X-----XXXXXXXXXX