------------------------
------------------------
------------------------
------------------------
------------------------
X-----------------------
X-----------------------
X-----------------------
X------o---------------D
X-----o-o---------SSS@SS
X----o-o-o--------------
X---o-o-o-o-------------
XD-----|-------D--oo----
XX-k---|----k--X--oo--g-
XXXXXXXXXXXXXXXXXXXXXXXX
XXXXXXXXXXXXXXXXXXXXXXXX