-----------------------
-----------------------
-----------------------
-----------------------
-----------------------
---------------o-------
-o-------------#-------
o-o-----------##-------
-o-o--------o-##-------
DDDDDDD-----#-##-------
-----------##-##-------
----------###-##-------
T-------o-###-##-------
t-------#-###-##g--g#--
t---TT--X-XXX-XXXXXXXXX
t---tt--X-XXX-XXXXXXXXX