------------------------
------------------------
------------------------
------------------------
------------------------
------------------------
------------------------
------------------------
X-----------------------
X-----------------------
X-----------------------
X-------C-S-S-C---------
X-----------------------
X-------ooo-------------
XXXXX--XXXXX-XXXX-------
XXXXX--XXXXX-XXXX-------