------------------------
------------------------
------------------------
------------------------
------------------------
------------------------
------------------------
------------------------
------------------------
-----------o------------
-----------o------------
X----------o------------
X----------o------------
X----------o------------
XXXX-------X-----XX-----
XXXX-------X-----XX-----