------------------------
------------------------
------------------------
------------------------
-----?------------------
------------------------
---------------------SSo
---SSSS-----------------
------------------------
------------------------
---------------%%%%%%---
----------SSS---||||----
%%%%------------||||----
|||-------------||||----
|||-------------||||----
|||-------------||||----