------------------------
------------------------
------------------------
------------------------
------------------------
------------------------
------------------------
------------------------
-------------------*----
-------------------*----
-----------------SS#CS--
-*-----K---*------------
-*---------*-----------*
-*---------B-----------*
XXXXXXXXXXXXXXXXXXXXXXXX
XXXXXXXXXXXXXXXXXXXXXXXX