------------------------
------------------------
------------------------
------------------------
------------------------
------------------------
-------------SSSSS------
------------------------
------------------------
--------------K---------
-------------SSSSS------
----------------K---#---
-*-----TT-----------#---
-*-----TT-----------#---
XXXXXXXXXXXXXXXXXXXXXXXX
XXXXXXXXXXXXXXXXXXXXXXXX