------------------------
------------------------
------------------------
------------------------
------------------------
K-----------------------
SS----1-----------------
------------------------
------------------------
------------------------
SS----------------------
------TT--------------TT
------TT---------*----TT
------TT---------*----TT
XXXXXXXXXXXXXXXXXXXXXXXX
XXXXXXXXXXXXXXXXXXXXXXXX