------------------------
------------------------
------------------------
------------------------
------------------------
------------------------
--!---------------------
------------------------
------------------------
------------------------
S@S!S-------------------
------------------tt----
--------tt--------tt----
-g------tt--------tt-g--
XXXXXXXXXXXXXXXXXXXXXXXX
XXXXXXXXXXXXXXXXXXXXXXXX