------------------------
------------------------
------------------------
------------------------
------------------------
------------------------
----------------------SS
------------------------
------------------------
------------------------
-------------------C----
------------#-----------
--------K---#-----------
------------#-----gg----
XXXXXXXXXX--XXXXXXXXXXXX
XXXXXXXXXX--XXXXXXXXXXXX