------------------------
------------------------
------------------------
------------------------
------------------------
------------------------
-----------@-----------S
------------------------
------------------------
------------------------
--SU----!--!--!-----S---
------------------------
------------------------
--------k---------------
XXXXXXXXXXXXXXXXXXXXXXXX
XXXXXXXXXXXXXXXXXXXXXXXX