------------------------
------------------------
------------------------
------------------------
------------------------
------------------------
SS----SSS---------------
------------------------
---------------S--------
------------------------
%%----SSS-----%%%%%%----
||---S---------|-||-----
||-------------|-||-%%--
||---------------||||---
||-------------%-|||||XX
||------------|--||||XXX