------------------------
------------------------
------------------------
------------------------
------------------------
-----------------------%
%%%%%%-------SSS--------
-||||-------------------
-||||------------------S
-|%||-------------------
-||||---------SSSS--%%%%
-||||----------------||-
-||||----------------||-
-||||----------------||-
-||||-XXXXXX-------%%||%
-||||-XXXXXX-------|-||-