------------------------
------------------------
------------------------
------------------------
%%%%%-------------------
-|||--------------------
-|||--------------------
-|||-----------|--------
-|||-----------|--------
-|||-----------|--------
-|||-%%--------|-|%----S
-|||-|---------|-|------
-|-||------------|------
-|-|||-----------|------
---|||-%%%%-----%|%%%%--
---|||--|||------|--||--