------------------------
------------------------
------------------------
------------------------
------------------------
------------------------
-oo------SS----SSS------
--ooo-------------------
S-----------------------
------------------------
-----%%%%%%----SSS-----%
--SS--||-||---S---------
------||-||-------------
------||-||-------------
------||-||-------------
------||-||------------|