------------------------
------------------------
--------------------%%%%
---------------------||-
---------------------||-
oooo-----------------||-
S--------------------||-
-------------------%-||-
--SS---|-------------||-
-------|-----SSSSS---||-
----%%%%------------|||-
-----|||------------||--
-----|||---------S--||--
-----|||------------||--
%%---||%%%---------|||--
|----||||----------|||--