------------------------
------------------------
------------------------
------------------------
------------------------
------------------------
------S-----------------
------------------------
-------------SSSS------o
------------------------
--%%%-------------SS---%
%%%|--------------------
||||--------------------
||||--------------------
||||%%%%%%-%%%----------
-|||-||||---|-----------