------------------------
------------------------
------------------------
------------------------
-------%%%--------------
ooo----||---------------
-------||---------S-%%%%
-------||------------||-
-------||-------------|-
-------||-------------||
SS-----%%-%%%%-----SS-||
--------||-||---------||
--------|--||---------||
-------||--||---------||
-----%%%|--||%%%------||
------|||--||-|-------||