------------------------
------------------------
------------------------
------------------------
------------------------
------------------------
-%%%%-------------------
--||--------------------
--||--ooo----%%%--------
--|-----o-----|---------
%%|%--SS------|----%%%--
-||-----------|-----|---
-||-----------|-----|---
-||-----------|-----|---
-||----------||-%%%%|%%%
-||-----------|--||-||--