------------------------
------------------------
------------------------
------------------------
------------------------
------------------------
--SS------oo------SS----
-----------ooo----------
oo---SSSSS--------------
------------------------
--%-----------%%%%%%----
---||%-----SS--||-||---S
---||----------||-||----
---||----------||-||----
%%-||----------||-||----
|--||----------||-||----