------------------------
------------------------
------------------------
------------------------
---------------------o--
-----------------SSS----
-SS---------------------
------------------------
--------|---------------
-------||------------SSS
-------||%%%%-----------
-------|||||------------
-------|||||------------
-------||||-------------
%%X----||||XXXXXX-%%%%--
-||-----|||XXXXXX-%||---