------------------------
------------------------
------------------------
------------------------
----o-------------------
SSS---------------------
-----------------o------
---------------SS-------
-------SSS----------S---
----SSS-----------------
----------------%%%-----
-----------------|------
-----------------|------
-----------------|------
-%%%%-------%%%--|------
-%||---------|---|------