------------------------
------------------------
------------------------
------------------------
------------------------
------------------------
---SSSS--------SSSSo----
------------------------
------------------------
------------------------
S-----%%%%%%-------SSSS-
-------|||-----------S--
-------||||-------------
-------||||-------------
-------||||-%%%%--------
-------||||--||---------