------------------------
------------------------
------------------------
------------------------
------------------------
---------------ooo------
-----S-------SSS------%%
-----------------------|
oo---------------SSS---|
-----------------------|
%%%%--%%%|-------------|
-||----|||-------------|
-|||---|||-------------|
-|||---||--------------|
-|||---||--------------|
-|||---||--------------|