------------------------
------------------------
------------------------
------------------------
------------------------
o-----------------------
--------S-----%-SSSSS---
------------------------
--%%%%------S-----------
--%||-------SSS---------
--|||--------------SS---
--|||-------------------
--|||-------------------
--|||-------------------
X-|||-%%%%%%--------%%%-
--|||-|||||----------|--