------------DD----------
------------DD----------
------------DD----------
------------DD----------
------------DD----------
------------DD----------
-----D------DD----------
----YD------DD----------
----DD------DD----------
-----D-XX---DD----XX----
-g-g-D-XX---DD----XX----
DDDDDD-D----------D---g#
-----D-D---------*D---##
-----D-D*--oooo--D---###
XXXXXX--DDDDDDDDD----XXX
XXXXXX---------------XXX