-----------------------
-----------------------
-----------------------
-----------------------
-----------------------
-----------------------
-----------------------
-----------------------
-TT--------------------
-TT--------------------
-TT-------------tt-----
-TT-----TT------tt-----
-TT-----TT------tt-TT--
-TT---k-TT------tt-TT--
XXXXXXXXXXXXXXXXXXXXXXX
XXXXXXXXXXXXXXXXXXXXXXX