----DD---------------D--
-----D---------------D--
-----D---------------D--
-----D---------------D--
-----D---------------D--
-----D---------------D--
---D-D---------------D--
--YD-D----------D----D--
--DD-D---------------D--
---D-DDDDDDDDDDDD----DDD
-g-D----------D---X-----
DDDD-o--------D---X-----
---D-*----------o-X-----
---D-D----r-----*-X-----
XXXXXXXXXXXXXXXXXXXXXXXX
XXXXXXXXXXXXXXXXXXXXXXXX