---D-------------DD-----
---D--------------D-----
---D--------------D-----
---D--------------D-----
---D--------------D-----
---D-----o--------D-----
-D-D----o-o-------D-----
YD-D---o-o-o--D---D-----
DD-DDDDDDDDDDDDo--D-----
-D-------------oD-DDDDDD
-DX------------oD-------
DDX*-----------DD-o-----
-DX*------------X-*-----
-DX---y-----y---X-D----r
XXXXXXXXXXXXXXXXXXXXXXXX
XXXXXXXXXXXXXXXXXXXXXXXX