----------------------D-
----------------------D-
----------------------D-
----------------------D-
----------------------Do
----------------------Do
-D----------------------
YD-------------o--------
DD-X-----------2X---#y-#
-D-X------------X#--####
-D-X-----------oX-------
DD-X-----------2X-------
-D-X------------X-------
-D-X-r-----r----X-------
XXXXXX--XX-XX-XXX-------
XXXXXX--XX-XX-XXX-------