----------DD------------
----------DD------------
-YYY------DD------------
-DDD------DD------------
---D------DD------------
---D------DD------------
-D-D------DD------------
-o-D------DD--------DDDD
-o-D------DD------------
DDDD-XX---DD----XX-D----
-----XX---DD----XX------
-----D----------D-------
-----D---------*D-------
-----D*--oooo--D--------
------DDDDDDDDD----XXXXX
-------------------XXXXX