------D-D---------------
------D-D---------------
------D-D---------------
------D-D---------------
------D-D---------------
------D-D---------------
------D-D------o--------
------D-D-----o-o-------
------D-D----o-o-o------
------D-DDDDDDDDDDDDD---
DDDDDD------------------
------------------------
-------------TT-------o-
-y-----------tt-------#-
XXXXXXX--TT--tt---TT--X-
XXXXXXXX-tt--tt---tt--X-