-----D------------------
-----D------------------
-----D------------------
--D--D------------------
-DD--D------------------
--D--D------------------
--D--D------o-----------
--D--D-----o-o----------
--D--D----o-o-o---------
--D--DDDDDDDDDDDDD----g#
--D-------------------##
--D-----------------g###
--D-------TT--------####
--D-------tt-------#####
X-XX--TT--tt---TT--XXXXX
X-XXX-tt--tt---tt--XXXXX