--------DDDDDDD---------
--------------D---------
-----YYY------D---------
-----DDD------D---------
-------D------D---------
-------D-X--ooD---------
-----D-D-X--ooD---------
-----o-D-X---o----------
-----o-D-X---o--------o-
D-DDDDDD-X------------D-
---------X--------------
---------X---------o----
---------X---------D----
---------X--------------
---------X---DD--------X
---------X-------------X