------------------------
------------------------
------------------------
------------------------
-----------------oo-----
-----------X------------
-----------X------------
----------XX------------
X--XXXXX-XXX-XXX----XX--
X--XXXXX-XXX-XXX----XX--
----------oX---X--------
----------oXX--X--------
----------oXX--X--------
-----g----oX---X--------
X--XXXXX-XXXXXXX--------
X--XXXXX-XXXXXXX--------