------------------------
------------------------
------------------------
------------------------
------------------------
------------------------
------------------------
------------o-----------
X-----------2X----------
X------------X-------o--
X-----------oX-------o--
X-----------2X-------o--
X------------X-------o--
X-r-----r----XD------r--
XXX--XX-XX-XXXXXX----D--
XXX--XX-XX-XXXXXX-------