---------------------------------------------------------------------------------------------------------------------------------------------------------------------
---------------------------------------------------------------------------------------------------------------------------------------------------------------------
---------------------------------------------------------------------------------------------------------------------------------------------------------------------
---------------------------------------------------------------------------------------------------------------------------------------------------------------------
------------------------------------o---oo---------------------------------------------------------------------------------------------------------------------------
-----------------------------------%%%ooo----------------------------------------------------------------------------------------------------------------------------
------------------------------SS----------%%%%---------------SSS--------------------SS------------%%%-----------------------------------oo---------------------------
-------------------------------------------||------------------------------------------------------||-----------------|--------------ooSSS---------------------------
-------------------SSS---------------------||---------SSSSooo---------------------------SS---------|-------SS-------%%|%-----SSSSSSS---------------------------------
-----------------------------------|-SSS---||------------------------------------------------------||----------------||----------------------------------------------
---------%%%%%%%S---------SSS-----||-------|||%----------------%%%%---------%%%%%SSS-----%---------|%%%%%%%-----SS---||%%%%------------SSS-||------------------------
----------||||--------SS---------|||-------||||--------------%|-||-----------|||-------------------||%%-||-----------||-||-----------------||------------------------
----%%%%%-||||-------------------|||-------||||--------------||-||-----------|||-------------------||||-||-----------|||||---------------%-||----------%%%%----------
M-----|||-||||-------------------|||-------||||--------------|||||---------|-|||-------------------||||-||-----------|||||-----------------||-----------||-----------
XXXX--|||-||||----------------%%||||-------||||---%%%%-----%-|||||-%%%%%---|-|||------------%%%%%--||||-||-%---------|||||----%%%%-------||||%%%%%%%%%%|||----------F
XXXX--|||-||||-----------------|||||-------|||-----||--------|||||--|||----|-|||-------------|||---||||--|-----------|-|||-----||%--------|||-||||-|||-|||-----------