------------------------
------------------------
------------------------
------------------------
------------------------
------------------------
------------------------
------------------------
--D---------------------
@SSSS---D---------------
----S---D---------------
-----SSSD---2122222222X-
------ooD-------ooooooX-
-g----ooD---g--gooooooX-
XXXXXXXXXXXXXXXXXXXXXXXX
XXXXXXXXXXXXXXXXXXXXXXXX