-D----------------------
-D----------------------
-D------------------#---
oD------------------#---
oD--------------------DD
-----------------#----DD
#----------------#------
-----------------#---D--
#g-g----------------#---
######--------------#---
--------------------#---
-------------oo----##---
---------#---##---###---
------X--#--y--y--###---
------XXXXXXXXXXXXXXX---
------XXXXXXXXXXXXXXX---