------------------------
------------------------
---#--------------------
---#--------------------
------------------------
#-----------------------
#--------o--------------
#-------Xo--------------
---#----Xo--------------
---#-XXXXXTTXXXXXX------
---#-XXXXXttXXXXXX-----o
--##------tt----------o-
-###------tt-------D----
-###------tt-------X-k--
XXXX------tt-------XXXXX
XXXX------tt-------XXXXX