------------------------
------------------------
------------------------
---G--------------------
---DD-------------------
---DD-------------------
---D--------------------
-gD--D------------------
-D-----------D----------
D-------SSS@SSSS---D----
D--------------S---D----
D---------------SSSD----
--------oo-------ooD----
--------oo--g----ooD-D--
------XXXXXXXXXXXXXXXXXX
------XXXXXXXXXXXXXXXXXX