---------------------D--
---------------------D--
----#----------------D--
----#----------------D--
---------------------D--
-#-------------------D--
-#-------------------D--
-#-------------------D--
----#----------------D--
----#----------------D--
----#----------------DDD
---##-------------------
--###-D-----*-----D-----
--###-D-----D-----D--k--
XXXXXXXXXXXXXXXXXXXXXXXX
XXXXXXXXXXXXXXXXXXXXXXXX