----DD------------------
-----D------------------
-----D------------------
-----D------------------
-----D------------------
-----D------------------
-----D------------------
-----D----------D-------
-----D-----------------o
DDD--DDDDDDDDDDDD------#
--------------D---X---##
-----o--------D---X--###
-----*----------o-Xo-###
-----D----r-----*-X#-###
TT--XXXXXXXXXXXXXXXX-XXX
tt--XXXXXXXXXXXXXXXX-XXX