------------------------
------------------------
------------------------
------------------------
-----------------------o
------------------------
-----------------o------
-----------------o------
-----------------o-XXX--
-----------------D-XXX--
-----o---------------X--
-----o----------*-X--X--
-D---o-------*--D-X--X--
-D------g--g-D--D----X--
XXXXXXXXXXXXXXXXXXXXXX--
XXXXXXXXXXXXXXXXXXXXXX--