------------------------
---L--------------------
------------------------
--K---------------------
%%%%--------------------
%%%%---------------D----
-||---------------------
-||---------------------
%%%%-----------TT-------
%%%%-----------tt----DD-
-----------TToott-------
-----------ttoott-------
-----------ttoott-------
-----------ttggtt-------
-----XXXXXXXXXXXXXXX----
-----XXXXXXXXXXXXXXX----