-------D----------------
-------D----------------
-------D----------------
-------D------------D---
-------D*-----------D---
-------DD----------DD---
-------D---------D--D---
--------------------D---
----------k----k----D%%%
-----X-XXXXXXXXXXXXXX%%%
----XX-XXXXXXXXXXXXXX---
-----X------------------
-----X------------------
--X-X-------------------
XXXXXX------------------
XXXXXX------------------