------------------------
------------------------
------------------------
------------------------
------------g-----------
----------DDD-----------
--------TTDD------------
--------tt--------------
--g-g---tt--------------
XXXXXTTXXXXXXDD---oooooo
XXXXXttXXXXXX-----TTTTTT
-----tt-----------tttttt
-----tt-----------tttttt
-----tt-----------tttttt
-----tt-----------tttttt
-----tt-----------tttttt