-------------D----------
-------------D----------
-------------D----------
-------------D----------
-------------D----------
-------------D----------
-------------D*---------
-----------o------------
-----------D-X*---------
-----------D-XX*------k-
-------------XXXXXXXXXXX
----------*-------------
-------*--D-------------
---k---D--D-------------
XXXXXXXXXXXX------------
XXXXXXXXXXXX------------