-----------D------------
-----------D------------
-----------D------------
-----------D------------
-----------D------------
-----------D-------o----
-----------D-------#----
-----------D------##----
-----------D----o-##----
-----------D----#-##----
DDDDDDDDDDD----##-##----
---oo---------###-##----
------------o-###-##----
-y----y-----#-###-##g--g
XXXXXXXXXXXXX-XXX-XXXXXX
XXXXXXXXXXXXX-XXX-XXXXXX