------------------------
------------------------
------------------------
------------------------
-------------------oo---
------------------------
------------------------
-------------D----------
---------------XXX----XX
------o----D---XXX----XX
------o----------X------
------o------DX--X------
------o------DX--X------
------r------D---X------
XX----D----XXXXXXX------
XX---------XXXXXXX------