------------------------
------------------------
------------------------
------------------------
---------------------oo-
---------------D--------
------------------------
------------------------
-----------TT----XXX----
-----------tt----XXX----
-------TToott------X----
-------ttoott---X--X----
-------ttoott---X--X----
-------ttggtt------X----
XXXXXXXXXXXXXXXXXXXX----
XXXXXXXXXXXXXXXXXXXX----