---------------D--------
---------------D--------
----#----------D--------
----#---#-----oD--------
------###-----oD--------
-#--------#--y----------
-#--------#####---------
-#----------------------
----#---------#g-g------
----#---------######----
----#-------------------
---##-------------------
--###-------------------
--###---------------D---
XXXXX---------------XXX-
XXXXX---------------XXX-