------------------------
------------------------
--------------------#---
--------------------#---
------------------------
-----------------#------
-----------------#------
-----------------#------
--------------------#-XX
o-------------------#-XX
o-------------------#---
o------------oo----##X--
---------#---##---###X--
D-gD-gX--#--y--y--###---
XXXXXXXXXXXXXXXXXXXXXXXX
XXXXXXXXXXXXXXXXXXXXXXXX