------------------------
--------------L---------
------------------------
-------------K----------
----------%%%%%---------
----------%%%%%---------
o-----------||----------
o---k---k---||----------
o-%%%%%%%%%%%%%---------
D-%%%%%%%%%%%%%--------o
--------||-------------o
--------||-------------o
--------||-------------o
--------||------D------r
X-------||------XXX----D
X-------||------XXX-----