------------------------
------------------------
------------------------
--gX-g------------------
XXXXXX----------------##
XXXXXX---------------X--
-----X---------------X#-
-----X--------------XX##
--------XXX--XXXXX-XXX--
--------XXX--XXXXX-XXX#-
-D-D-DD-------------oX##
-D-D-D-X------------oX--
-D-D-DDX------------oX--
--D---D--------g----oX--
--D--DDXXXX--XXXXX-XXX--
-------XXXX--XXXXX-XXX--