------------------------
------------------------
------------------------
------------------------
------------------------
------------------------
------------------------
-D----------------------
------------------------
DD--------------------o-
---X-------o-----*D---#-
---X-------o----ooD--##-
-o-Xo------o----DDD--##-
-*-Xo------g-----*D#-##-
XXXXX------X-----XXX-XX-
XXXXX------X-----XXX-XX-