-------D------------DDD-
-------D------------D-D-
-------D------------D-D-
-------D------------D-D-
-------D------------D-D-
-------D------------D-D-
-------D*-----------D-D-
--------------------D-D-
-------X*-----------D-D-
---XX--XX*------k---D-DD
---XX--XXXXXXXXXXXXo----
---D--------------Xo--o-
--*D--------------Xo--*-
--D---------------Xo--D-
DD----------------XXXXXX
------------------XXXXXX