----------------------DD
----------------------DD
----------------------DD
----------------------DD
----------------------DD
----------------------DD
---------------o------DD
o--------------o------DD
D--------------o------DD
D--------------D-XX---DD
---o-------------XX---DD
---o----------*--D------
---o-------*--D--D------
------g--g-D--D--D*--ooo
XXXXXXXXXXXXXXXX--DDDDDD
XXXXXXXXXXXXXXXX--------