------------------------
------------------------
------------------------
-----------------------o
------------------------
------------------------
-----------------------#
---------------------g##
---------------------###
-------------------g####
X-------o-----*D---#####
X-------o----ooD-g######
Xo------o----DDD-#######
Xo------g-----*D########
XX------X-----XXXXXXXXXX
XX------X-----XXXXXXXXXX