------------------------
------------------------
----------------------#-
----------------------#-
------------------------
-------------------#----
-------------------#----
-------o-----------#----
-------D--------------#-
-------D--------------#-
----------------------#-
------*--------oo----##-
---*--D----#---##---###-
---D--D-X--#--y--y--###-
XXXXXXXXXXXXXXXXXXXXXXXX
XXXXXXXXXXXXXXXXXXXXXXXX