------------------------
------------------------
------------------------
------------------------
------------------------
------------------------
------------------------
----------------o-------
----------------D-------
----------------D-------
----o------------------T
----o----------*-------t
D---o-------*--D-------t
D-------k---D--D-------t
XXXXXXXXXXXXXXXXXXXXXXXX
XXXXXXXXXXXXXXXXXXXXXXXX