DD----------------------
-D----------------------
-D----------------------
-D----------------------
-D----------------------
-D----------------------
-D----------------------
-D----------D-----------
-D----------------------
-DDDDDDDDDDDD-----------
----------D---X------TT-
-o--------D---X-----otto
-*----------o-X-----otto
-D----r-----*-XX-X--otto
XXXXXXXXXXXXXXXXXXXXXXXX
XXXXXXXXXXXXXXXXXXXXXXXX