------------------------
------------------------
------------------------
------------------------
-------oo---------------
--------------oX--------
--------------oX--------
--------------XX--------
---XXX----XX--XX-----g-g
-X-XXX----XX--XX-XXXXXXX
XX---X---------X-XXXXXXX
-XX--X---------X--------
-XX--X---------X--------
X----X---------X--------
XXXXXX---------X--------
XXXXXX---------X--------