------------------------
------------------------
------------------------
------------------------
------------------------
----------------------o-
--------------D-------#-
-------------YD------##-
-------------DD----o-##-
--------------D----#-##-
--------g-g-g-D---##-##-
----DDDDDDDDDDD--###-##-
---D----------Do-###-##-
--D-----------D#-###-##g
XXXXXXXXXXXXXXXX-XXX-XXX
XXXXXXXXXXXXXXXX-XXX-XXX