---D--------------------
---D--------------------
---D--------------------
---D--------------------
---D--------------------
---D--------------------
---D--------------------
---D--------------------
---D------o-------------
---D-----o-o------------
DDD-----o-o-o-----------
----K--o-o-o-o--K------D
----D---D---D---D-----D-
------D---D---D------D--
XXXXXXXXXXXXXXXXXXXXXXXX
XXXXXXXXXXXXXXXXXXXXXXXX