------------------------
------------------------
------------------------
------------------------
------------------------
------------------------
------------------------
------------------------
-------D----------------
--SSS@SSSS---D----------
-------------D-------TTo
----------SSSD-------tto
--oo-------ooD-------tto
--oo--g----ooD-------ttg
XXXXXXXXXXXXXXXXXXXXXXXX
XXXXXXXXXXXXXXXXXXXXXXXX