--------------D---------
--------------D---------
------------#-D---------
------------#-D---------
--------------D*--------
---------#----DD--------
---------#----D---------
---------#--------------
------------#----k----k-
------------#-XXXXXXXXXX
------------#-XXXXXXXXXX
-----oo----##-----------
-#---##---###-----------
-#--y--y--###-----------
XXXXXXXXXXXXX-----------
XXXXXXXXXXXXX-----------