--------------------D---
--------------------D---
---#----------------D---
---#----------------D---
--------------------D---
#-------------------D---
#-----------------o-D---
#-----------------o-D---
---#--------------o-D---
---#--------------D-D---
---#--o-------------DDDD
--##--o----------*------
-###--o-------*--D------
-###-----g--g-D--D--k--y
XXXXXXXXXXXXXXXXXXXXXXXX
XXXXXXXXXXXXXXXXXXXXXXXX