------------------------
------------------------
------------------------
------------------------
------------------------
------------------------
--------------------o---
-----o--------------o---
-----D--------------o---
-----D--------------D---
--------o---------------
----*---o----------*----
-*--D---o-------*--D----
-D--D------g--g-D--D-D--
XXXXXXXXXXXXXXXXXXXXXXXX
XXXXXXXXXXXXXXXXXXXXXXXX