--DDD-------------------
--D-D-------------------
--D-D-------------------
--D-D-------------------
--D-D-------------------
--D-D-------------------
--D-D-------------------
--D-D----------D--------
--D-D-----------------o-
--D-DDDDDDDDDDDD------#-
Xo-----------D---X---##-
Xo--o--------D---X--###-
Xo--*----------o-Xo-###-
Xo--D----r-----*-X#-###-
XXXXXXXXXXXXXXXXXXX-XXX-
XXXXXXXXXXXXXXXXXXX-XXX-