------------------------
------------------------
------------------------
------------------------
------------------------
----------------------#-
----------------------#-
----------------------#-
---o--o-----------------
---o--o-----------------
------------------------
---!--!-----------oo----
--------------#---##---#
--------g-gX--#--y--y--#
XXXXXXXXXXXXXXXXXXXXXXXX
XXXXXXXXXXXXXXXXXXXXXXXX