------------------------
------------------------
------------------------
------------------------
------------------------
------------------------
------------------------
---------------D--------
-----------------X------
--------o----D---X------
--------o--------X------
--------o------D-X------
--------o------D-X------
-D------r------D-X-r----
XXXX----D----XXXXXXX--XX
XXXX---------XXXXXXX--XX