------------------------
------------------------
------------------------
------------------------
-g----------------------
DD--------------D-------
D-----------------------
------------------------
------------TT---------o
XX----------tt--------o-
XX------TToott-------o-o
--------ttoott------o-o-
--------ttoott---D-----|
--------ttggtt---X-k---|
--XXXXXXXXXXXXXXXXXXXXXX
--XXXXXXXXXXXXXXXXXXXXXX