----D-------------------
----D-------------------
----D-------------------
----D------------D------
----D*-----------D------
----DD----------DD------
----D---------D--D------
-k---------------D------
XX-----k----k----D------
XX--XXXXXXXXXXXXXX------
----XXXXXXXXXXXXXX------
------------------------
---------------------#--
------------------X--#--
------------------XXXXXX
------------------XXXXXX