D-----------------------
D-----------------------
D-----------------------
D-----------------------
D-----------------------
D--------------D--------
D-----------------------
D-----------------------
D----------TT-----------
D----------tt---DD---ooo
-------TToott--------TTT
-------ttoott--------ttt
-------ttoott--------ttt
-------ttggtt--------ttt
XXXXXXXXXXXXXXXX-----ttt
XXXXXXXXXXXXXXXX-----ttt