---D--------------------
---D--------------------
---D--------------------
---D--------------------
D--D--------------------
D--D--------------------
---D--------------------
-D-D--------------------
---DDDDDDDDDDD----------
------------------------
------------------------
-------o--------Y-------
-------o--------Y-------
-------o-----Dy-D-------
--X----X-----XXXXX------
--X----X-----XXXXX------