---U----------D---------
--------------D---------
---D----------D---------
-----D--------D---------
---D----------D---------
-----D--------D---------
---D----------D---------
-g--g---------D---------
DDDDDD--------D---------
------D-------D---------
-------D------DDDDDDDDDD
-ooo----D----------oo---
-o-o-----D--------------
-ooo------D---k--y----y-
-----------XXXXXXXXXXXXX
-----------XXXXXXXXXXXXX