------------------------
------------------------
------------------------
------------------------
------------------------
--------------D---------
------------------------
------------------------
----------TT-------ooo--
----------tt----DD-DDDD-
------TToott------------
------ttoott------------
------ttoott------------
------ttggtt------------
XXXXXXXXXXXXXXX---------
XXXXXXXXXXXXXXX---------