------------------------
------------------------
------------------------
------------------------
------------------------
------------------------
------------------------
------------------------
------------------------
-------------------XXXXX
-----------TT-----XXXXXX
-S-C------otto-----X----
----------otto-----X----
-----X-X--otto--X-X-----
X-XXXXXXXXXXXXXXXXXX----
X-XXXXXXXXXXXXXXXXXX----