-------------DDDDDDD----
-------------------D----
-------------------D----
-------------------D----
---oo--------------D----
----------oX--X--ooD----
----------oX--X--ooD----
----------XX--X---o-----
XX----XX--XX--X---o-----
XX----XX--XX--X---------
-X---------X--X---------
-X---------X--X---------
-X---------X--X---------
-X---------X--X---------
XX---------X--X---DD----
XX---------X--X---------