------------------------
------------------------
------------------------
------------------------
------------------------
------------------------
------------------------
------------------------
XX----------------------
XX---------------X------
---------TT-----XX------
--------otto-----X------
--------otto-----X---#--
---X-X--otto--X-X-X--#--
---XXXXXXXXXXXXXXXXXXXXX
---XXXXXXXXXXXXXXXXXXXXX