------------------------
------------------------
------------------------
------------------------
-----------------oo-----
------------------------
------------------------
-----------o------------
-----------D-XXX----XX--
-----------D-XXX----XX--
---------------X--------
----------*-X--X--------
-------*--D-X--X--------
---k---D--D----X--------
XXXXXXXXXXXXXXXX--------
XXXXXXXXXXXXXXXX--------