D-----------------------
D-----------------------
D-----------------------
D-----------------------
D-----------------------
D-----------------------
D-----------------------
D-----------------------
D------o----------------
D-----o-o---------------
-----o-o-o--------------
-K--o-o-o-o--K------DDDD
-D---D---D---D-----D----
---D---D---D------D-----
XXXXXXXXXXXXXXXXXXXXXXXX
XXXXXXXXXXXXXXXXXXXXXXXX