----DD------------------
-----D------------------
-----D------------------
-----D------------------
-----D------------------
-----D------------------
-----D------------------
-----D----------D-------
-----D------------------
DDD--DDDDDDDDDDDD-------
--------------D---X-----
-----o--------D---X-----
-----*----------o-X-----
-----D----r-----*-XX-X--
TT--XXXXXXXXXXXXXXXXXXXX
tt--XXXXXXXXXXXXXXXXXXXX