------------------------
------------------------
------------------------
--------------------o---
-------o-*D--------o----
-------D--D-------o-----
----------D-------#-----
---o------D------##-----
---D------D------##-----
-o-------*D---o--##-----
-D--------D---#--##-----
-----o----D--##--##-----
-----D----D--##--##-----
---r------D#-##--##----#
X--X--X---XX-XX--XXXXXXX
X--X--X---XX-XX--XXXXXXX