------------------------
------------------------
-------------#----------
-------------#-------o--
------------------------
----------#-------------
----------#----------#--
----------#--------g##--
-------------#-----###--
-------------#---g####--
-------------#---#####--
------oo----##-g######--
--#---##---###-#######--
--#--y--y--###########--
XXXXXXXXXXXXXXXXXXXXXXXX
XXXXXXXXXXXXXXXXXXXXXXXX