D-----------------------
D-----------------------
D-----------------------
D-----------------------
D-----------------------
D-----------------------
D----------------D------
D---------------YD------
D---------------DD------
D----------------D-XX---
-----------g-g-g-D-XX---
-------DDDDDDDDDDD-D----
oo----D----------D-D----
-y---D-----------D-D*--o
XXXXXXXXXXXXXXXXXX--DDDD
XXXXXXXXXXXXXXXXXX------