D----------------D------
D----------------D------
D----------------D------
D----------------D------
D----------------D------
D----------------D------
D----------------D------
D----------------D------
D-------D--------D------
D--SSS@SSSS---D--D------
--------------D--DDDDDDD
-----------SSSD-------oo
---oo-------ooD---------
---oo--g----ooD--k--y---
XXXXXXXXXXXXXXXXXXXXXXXX
XXXXXXXXXXXXXXXXXXXXXXXX