------------------------
------------------------
------------------------
------------------------
------------------------
-----------------oooo---
----------------SS------
------------------------
-SSS--%%%----------SSoo-
-------||------------S--
-------||%%----------S--
-------||------------S--
-------||---------------
-------|||--------------
%------|||---%%%%%%-----
-------|||----||||------