------------------------
------------------------
------------------------
------------------------
----------------o-------
----------%oooo-%o---o--
----------SS----%%%-----
-----------------|------
-------------SSS-|------
-----------------||-----
--------SS-------||-----
-----------------||-----
-----------------|||----
-----------------|||----
X---%%%%%--------||||%%%
XX---|||---------||||||-