------------------------
------------------------
------------------------
------------------------
------------------------
------------------------
------SS------oo------SS
---------------ooo------
SSSooo---SSSSS----------
------------------------
------%-----------%%%%%%
-------||%-----SS--||-||
-------||----------||-||
-------||----------||-||
%%%%%%-||----------||-||
|||||--||----------||-||