------------------------
------------------------
------------------------
------------------------
------------------------
------------------------
%%%%--------------------
-||---------------------
-||------SSS--%%%-------
-||------------||-------
-||------------||%%-----
-||------------||-------
-||------------||-------
-||------------|||------
-|%%%%%%%------|||---%%%
-||---||-------|||----||