------------------------
------------------------
------------------------
------------------------
------------------------
------------------------
------------------------
--oo--------------------
------------------SSS---
------------------------
--SSSSS-------S---------
------------------------
------------------------
------------------------
%----%%%%%%--XXXXXX----%
------|--|---XXXXXXX----