------------------------
------------------------
------------------------
------------------o-----
-----------------o------
----------------o-------
----------------#-------
-------o-------##-------
-------2X------##-------
--------X---o--##-------
-------oX---#--##-------
-------2X--##--##-------
--------X--##--##-------
---r----X#-##--##----#--
XX-XX-XXXX-XX--XXXXXXXXX
XX-XX-XXXX-XX--XXXXXXXXX