------------------------
------------------------
------------------------
------------------------
------------------------
------------------------
2-----------------------
------------------------
-------------y----------
-------------#SS-?Q-----
2-----------##----------
-----------###----------
----------####-------y--
-y-------#####---SSSSS--
XXXXXXXXXXXXXX-------XX-
XXXXXXXXXXXXXX-------XX-