------------------------
------------------------
------------------------
------------------------
------------------------
------------------------
Q-----------USSS--------
------------------------
------------------------
------------------------
Q----------S-----TT---QQ
-----------------TT-----
-----------------TT-----
---gg----k-ggg---TT-----
XXXXXXXXXXXXXXXXXXXXXXXX
XXXXXXXXXXXXXXXXXXXXXXXX