-----------------------
-----------------------
-----------------------
-----------------------
-----------------------
--------------------k--
---------------S---SSSS
-----------TT----------
-----------TT----------
-----------TT----------
--tt------SXXS---------
--tt-------------------
--tt-TT--------TT------
--tt-TT--------TT------
XXXXXXXXXXXXXXXXXXXXXXX
XXXXXXXXXXXXXXXXXXXXXXX