-----------------------
-----------------------
-----------------------
-----------------------
-----------------------
-----------------------
---------LSSS----------
-----------------------
-----g-----------------
-----#-----------------
----##---2-----#-------
---###---------#-------
--####---------##------
-#####----kk---##---gg-
XXXXXXXXXXXXXXXXXXXXXXX
XXXXXXXXXXXXXXXXXXXXXXX