------------------------
------------------------
------------------------
SSSSSSSSSSSSSSSSSSSSSSSS
------------------------
------------------------
------------------------
------------------------
------------------------
---------------------C--
--@QQQQ--------#-#------
-------------#-#-#-#---#
---------g-#-#-#-#-#---#
--------g#-#-#-#-#-#-E-#
XXXXXXXXXXXXXXXXXXXXXXXX
XXXXXXXXXXXXXXXXXXXXXXXX