------------------------
------------------------
------------------------
------------------------
------------------------
------------------------
!S----------------------
------------------------
------------------------
------------------------
S------#--#----------##-
------##--##--------###-
-----###--###------####-
----####--####----#####-
XXXXXXXXXXXXXXXXXXXXXXX-
XXXXXXXXXXXXXXXXXXXXXXX-