------------------------
------------------------
------------------------
------------------------
------------------------
------------------------
------------------------
------------------------
-y---------------------#
-#SS-?Q---------------##
##-------------------###
##------------------####
##-------y---------#####
##---SSSSS-----y--######
XX-------XX-XXXXXXXXXXXX
XX-------XX-XXXXXXXXXXXX