------------------------
------------------------
------------------------
U-----------------------
------------------------
------------------k-----
------------------##----
--SS-------------###----
-------#--------####----
------##-------#####----
-----###------######----
----####-----#######----
---#####----########----
--######---#########----
X-XXXXXXXXXXXXXXXXXXXXXX
X-XXXXXXXXXXXXXXXXXXXXXX