------------------------
------------------------
------------------------
------------------------
------------------------
------------------------
------------##----------
------------##----------
------------##----------
-----K---#--##----------
--------##--##----------
-------###--##----------
------####--------------
-----#####------------#-
XXXXXXXXXXXXXXXXXXXXXXXX
XXXXXXXXXXXXXXXXXXXXXXXX