------------------------
------------------------
------------------------
------------------------
------------------------
------------------------
S-----------------------
-------TT---------------
-------TT---------------
-------XX---------------
---TT----------------TT-
---TT-------------K--TT-
---TT-----TTTT-------TT-
k--TT-----TTTT-------TT-
XXXXXXXXXXXXXXXXXXXXXXXX
XXXXXXXXXXXXXXXXXXXXXXXX