-----------------------
-----------------------
-----------------------
-------------U---------
-----------------------
-----------------------
S----------------------
---------------SS------
--------------------#--
-----------SS------##--
S-----------------###--
---#----*--------####--
---#----*-------#####--
---#----*------######--
XXXXXXXXXXXXXX-XXXXXXXX
XXXXXXXXXXXXXX-XXXXXXXX