------------------------
------------------------
------------------------
------------------------
------------------------
------------------------
------------------------
------------------------
------------------------
--1--------o--------o---
----------------TT------
----TT----------TT------
----TT----------TT------
---kTT----------TT------
XXXXXXXXXXXXXXXXXXXXXXXX
XXXXXXXXXXXXXXXXXXXXXXXX