---------------------D--
---------------------D--
---------------------D--
---------------------D--
---------------------D--
---------------------D--
-------------------D-D--
------------------YD-D--
------------------DD-D--
---D---------------D-D--
---D---------g-g-g-D-DDD
SSSD-----DDDDDDDDDDD----
-ooD----D----------D----
-ooD---D-----------D-k--
XXXXXXXXXXXXXXXXXXXXXXXX
XXXXXXXXXXXXXXXXXXXXXXXX