------------------------
------------------------
------------------------
------------------------
------------------------
------------------------
------------------------
------------o-----------
X-----------2X----------
X------------X----------
X-----------oX----------
X-----------2X-------C-S
X------------X----------
X-r-----r----X-------ooo
XXX--XX-XX-XXXXXXX--XXXX
XXX--XX-XX-XXXXXXX--XXXX