------------------------
------------------------
------------------------
------------------------
------------------------
------------------------
-----------SSS-------%%%
------------S--------||-
---SS----------------||-
---------------------||-
---------------------||-
-------------------||||-
-------------------||||-
-------------------||||-
X-XXX---XXXXXXX----||%%-
XX-XX---XXXX-XX----||||-