------------------------
------------------------
------------------------
------------------------
------------------------
------------------------
SS-------------SSS------
------------------------
------------------------
------------------------
------%%%%%-----------%%
-------|||-------------|
-------|||-------------|
-------|||-------------|
%%%%%%-||%%%%%%-%%%%%%%|
||-||--|||-|||---||-||-|