------------------------
------------------------
------------------------
------------------------
------------------------
------------------------
----SS----SSS-----------
------------------------
-------------------S----
------------------------
%%%%%%----SSS-----%%%%%%
-||-||---S---------|-||-
-||-||-------------|-||-
-||-||---------------|||
-||-||-------------%-|||
-||-||------------|--|||