------------------------
------------------------
------------------------
------------------------
------------------------
------------------------
--------SSSSSSS---------
------------------------
------------------oo----
------------------------
S---------------SS------
------------------%%%---
-------------------||---
-------------------||---
%%%%%--%%%%%-------||---
-|||----||||-------||---