------------------------
------------------------
------------------------
------------------------
------------------------
------------------------
-SSSS---------------SSS-
------------------------
------------------------
------------------------
---------%%%---%%%------
----------||%%%%|-------
----------||-||||-------
----------||-||||-------
%%%%-----%|||||||-------
|||-------||-||||-------