------------------------
------------------------
------------------------
------------------------
------------------------
------------------------
---SSS-------%%%--------
----S--------||---------
-------------||---------
-------------||---------
-------------||---------
-----------||||-%%%%%-%%
-----------||||--||||--|
-----------||||--||||--|
XXXXXXX----||%%--||||%-|
XXXX-XX----||||--||||--|