------------------------
------------------------
------------------------
------ooo---------------
------------------------
------------------------
------SSS-------------SS
------------------------
SSS--------------o------
-----------------ooo----
-----------%%%--%%%%----
------------||---||-----
------------||---||-----
------------||---||-----
------------||----|%%%--
------------||----|||---