------------------------
------------------------
------------------------
------------------------
-----------------------o
---------------------oo-
---------SS-------SSSS--
----oo------------------
-SS---------S-----------
------------------------
%%%%--SS%---------------
-||---------------------
-||-----%---------------
-||----||---------------
-||----||-------%%%-----
-||----||--------|%-----