------------------------
------------------------
------------------------
------------------------
------------------------
------------------------
--SS--------------------
------oo----------------
-----------%%%----------
------------|-----------
-------%%%%||-----------
--------||-||-----------
-----%%%||-|------------
------||||--------------
X-----||||-XXXXXXXXXXXX-
X-----||||XXXXXXXXXXXXX-