------------------------
------------------------
------------------------
------------------------
------------------------
--oo--------------------
------------------------
------------------------
--SSS------%%%%--------S
------------||----------
-|-----%%%%|||----------
-|----%-||-|||----------
%%%----|||||||----------
-||----||||-||----------
-||%%%%||||-%%XXXXXXXXXX
-||-|--||||-|||XXXXXXXXX