------------------------
------------------------
------------------------
------------------------
-----o-------%%%%-------
-------------|||--------
-SSSS--------|||--------
-------------||---------
-------------||---------
-----SSS-----||--SS----|
---%%--------||--------|
-------------||--------|
%%%|---------||--------|
-|||---------||--------|
-|||---------||--------|
-|||---------||--------|