------------------------
------------------------
------------------------
------------------------
------------------------
------------------------
------------------------
------------------------
------------------------
------------------------
----------------%%------
--------------%%|-------
--------------|||-------
--------------|||-----X-
%%%%%%-%%%%%%%|||-XXXXXX
-|||-----|||--|||-XXXXXX