------------------------
------------------------
------------------------
------------------------
------------------------
-----Soooo--------------
------------------------
------------------------
-S-----SSS--------------
------------------------
%---------------%%%-----
-----------------|------
-----------------|------
-----------------|------
--------XXXXXXXXXXXX-%%%
-------XXXXXXXXXXXXX--||