------------------------
------------------------
------------------------
------------------------
------------------------
------------------------
%%%%%%------------S--SSS
--|||-------------------
-||||-------------------
-||||-------------------
-||||-------%%%%%-----S%
-||||--------|||--------
|||||--------|||--------
|||||--------|||--------
|||||--%-%%%%%||%----XXX
|-|||-----|||-||------XX