------------------------
------------------------
------------------------
------------------------
------------------------
------------------------
-------SSS-------%%%----
--------S--------||-----
S----------------||-----
-----------------||-----
-----------------||-----
---------------||||-%%%%
---------------||||--|||
---------------||||--|||
X---XXXXXXX----||%%--|||
X---XXXX-XX----||||--|||