------------------------
------------------------
------------------------
------------------------
------------------------
---o--------------------
%------SSS-----------S--
-------S----------------
--------------SSS-------
|-----------------------
|---------SS------%%----
|------------------|----
||-----------------|----
||-----------------|----
|||%%%-------%%%%%%%--%%
|||||--------||||||-----