------------------------
------------------------
------------------------
------------------------
------------------------
------------------------
-------S-------SS-------
------------------------
------------------------
------------------------
%%---S--%%%%%%----%%%%--
||-------||||------||---
||-------||||------||---
||-------||||------||---
||-------|||%%%%%%%||---
||-------|||-||--|-||---