------------------------
------------------------
------------------------
------------------------
------------------------
------------------------
S---------------SSS-----
------------------------
------------------------
------------------------
-----%%%---%%%----------
------||%%%%|-----------
------||-||||-----------
------||-||||-----------
-----%|||||||-----------
------||-||||-----------