------------------------
------------------------
------------------------
----------ooo-----------
------------------------
------------------------
----------SSS-----------
------------------------
----SSS--------------o--
---------------------ooo
%%%%-----------%%%--%%%%
|||%------------||---||-
|||-------------||---||-
|||-------------||---||-
|||-------------||----|%
|||-------------||----||