------------------------
------------------------
------------------------
oo----------------------
------------------------
-------------o----------
SS------SS--------------
------------------------
-------------------S----
------------------------
---%%%%--------------%%%
----||oo--------------||
----||-------------|--||
----||-------------|--||
---%%%%%%%--%%%%%--|--||
----|||||----|||---|--||