------------------------
------------------------
------------------------
------------------------
------------------------
------------------------
%%----------------------
|-----------------------
|------------oo-%%%-----
|-------oooSSS---|------
|S----SSS--------|%%%%%-
|----------------|||||--
|-----------------||||--
|-----------------||||--
%%----------------||||-%
|-----------------||||--