------------------------
------------------------
------------------------
------------------------
--------oo--------------
--------%---------------
-------S--------------%%
-----------------------|
-------------SSS-------|
-------SSS-------------|
-----------------------|
-----------------------|
-----------------------|
-----------------------|
%%%%%%%%----%%--%%%----|
-|--|||------|---|-----|