------------------------
------------------------
--------------------%---
------------oo------|---
-------------------%|%--
ooo-----------------|---
-----SS-----SSS-----|--%
--------------------|-|-
S-----------------S-|||-
--------------------|||-
-----SS-------------|||-
----------------------|-
----------------------|-
----------------------|-
---------%%%%%%-------|-
----------|||---------|-