------------------------
------------------------
------------------------
------------------------
------------------------
------------------------
------------%%%---------
-------------|----------
-------------|----------
-------------|----------
----------%%%%%%------%%
-----------||||--------|
--------%%%||||--------|
---------|-||||--------|
%%%------||||||-----%%%|
||-------||||||------|-|