------------------------
------------------------
------------------------
------------------------
%%%---------o-%%%-------
-|---------%---|--------
-|-------------|--------
-|-------------|--------
-|%%%-----SS---|---SS---
-|-|-----------|--------
-|-|%%%%--------%%%%----
-|-|-||----------||-----
-|-||||----------||-----
---||||----------||-----
---||||----------||-----
---||||----------||-----