------------------------
------------------------
------------------------
------------------------
------------------------
------------------------
----------------SSS-----
------------------------
-----oo-----------------
----SS------------------
SS-------%%%%-----------
-----------|------------
-----------|------------
-----------|------------
-------%%%%|%%%%%%%-----
--------||-||-||||------