------------------------
------------------------
------------------------
------------------------
----------------SS------
------------------------
-o----------SS----------
S-----------------------
----S-------------------
------------------------
%%%--------------S%%%%%%
-|-----------------||||-
-|-----------------||||-
-|-------------------||-
-|--------%%%%%%%--%%|||
-|---------|||-------||-