------------------------
------------------------
------------------------
------------------------
------------------------
------------------------
SSSSS--------------SS---
------------------------
--------SSS-------------
--------------ooo-------
------------S-----------
------------------------
---%%%%-----------------
----||------------------
----||--------------%---
----||------------------