------------------------
------------------------
------------------------
o-----------------------
------------%%%---------
---ooo-------|---------%
-------------|----------
-------------|----------
----SSS------|%%%-----SS
-------------|-|--------
-%-----------|-|%%%%----
--%%%%%------|-|-||-----
---|||-------|-||||-----
---|||---------||||-----
%--|||---------||||-----
---|||---------||||-----