------------------------
------------------------
------------------------
------------------------
------------------------
-------------o----------
-------SSS-----------S--
------------------------
-----------S---%%%%-----
---------------%||------
--%------------|||------
%%-------------|||------
||-------------|||------
||-------------|||------
||----XXXXXXXX-|||-%%%%%
||---XXXXXXXX--|||-|||||