------------------------
------------------------
------------------------
------------------------
------------------------
------------------------
----------------%%%-----
-----------------|------
SSS--------------|------
-----------------|------
--------------%%%%%%----
---------------||||-----
------------%%%||||-----
-------------|-||||-----
%%%%%%%------||||||-----
-||-||-------||||||-----