------------------------
------------------------
------------------------
------------------------
------------------------
------------------------
------SS----------------
------------------------
--------------------SSS-
------------------------
%%--------%%%%----------
||---------||-----------
||---------|------------
||----------------------
||-----%%%XXXXXXXXXXXXX-
||----|--|XXXXXXXXXXXXX-