------------------------
------------------------
------------------------
------------------------
------------------------
------------------------
---SSS-----------S------
---S-----------------oo-
----------SSS-----------
------------------------
------SS------%%----SSSS
---------------|--------
---------------|--------
---------------|--------
%%-------%%%%%%%--%%----
|--------||||||---------