------------------------
------------------------
------------------------
------------------------
-----------o------------
------------------------
-----------------%%-----
-----------------|------
-----------------|------
--------%--------|------
-----%%%%--------|-%%%%%
------||-------------|--
-----|||----------------
-----|||---------------|
XXX--|||-----------%%--|
XX---|||---------------|