------------------------
------------------------
------------------------
------------------------
------------------------
----------ooo-----------
S-------SSS------%%%%---
------------------||----
------------SSS---||----
------------------||----
-%%%|-------------||----
--|||-------------||----
--|||-------------||----
--||--------------||----
--||--------------|%%%%%
--||--------------||---|