------------------------
------------------------
------------------------
------------------------
------------------------
------------------------
----------------SS------
------------------------
--oo------------o----%%%
--SS------------%----||-
-----------%---------||-
-----%%%%%%----------||-
------|-|||-----------||
------|-|||-----------||
%%%%%%|||||-----------||
|||||-|-|||-----------||