------------------------
------------------------
------------------------
------------------------
------------------------
------------------------
-------------%%%%%------
--------------|||-------
--------------|||-------
--------------|||-------
---S------SSS-|||------S
--------------|||%%%----
--------------||||||----
---------------|||||----
%-%%%%---------|||||--%%
---||----------|||||---|