------------------------
------------------------
------------------------
------------------------
-o----------------------
------------------------
---S--------%%%-SSS-----
------oo-----|----------
-------------|----------
-------------|----------
%%-----S-----|-%%%%-----
|-----------%||-||------
|------------||-||------
|------------||-||------
|--------%%%%||-||----%X
|---------||-||--|-----X