------------------------
------------------------
------------------------
------------------------
------------------------
------------------------
--------SS-----------SSS
------------------------
--------o----%%%--------
--------%----||---------
---%---------||---------
%%%----------||---------
|||-----------||--------
|||-----------||--------
|||-----------||--------
|||-----------||--------