------------------------
------------------------
------------------------
------------------------
-------------------ooo--
-----------------o------
------------------------
------------------------
S------oo-------------S-
------------------------
--SS---%%%--------------
--------||--------------
--------||-%%%%---------
--------||--||----------
--------||%%|%%%-%%%%%%%
--------||--|||---|||||-