------------------------
------------------------
------------------------
------------------------
------------------------
-----o------------------
------------------------
-----------oo-----------
-----SSSSS----------%%--
---------------------|--
----------%%%%--------%%
-----------|---------|||
-----------|-----------|
----------||-----------|
%%%%%%%%%-||-%%%-------|
-||-|-|----|-||--------|