------------------------
------------------------
------------------------
------------------------
------------------------
------------------------
-------SSS--------------
------------------------
SSSSooo-----------------
------------------------
---------%%%%---------%%
-------%|-||-----------|
-------||-||-----------|
-------|||||---------|-|
-----%-|||||-%%%%%---|-|
-------|||||--|||----|-|