------------------------
------------------------
------------------------
------------------------
------------------------
oo-------%%%-----------|
------%%%||------oo----|
-------||||------------|
SSSS---||||---SSS------|
-------||||------------|
-------||||-------SS---|
-------||||------------|
-------||||------------|
-------||||------------|
-------||||------------|
-------||||------------|