------------------------
------------------------
------------------------
------------------------
------------------------
------------------------
S--------------------SS-
------------------------
------------------------
------------------------
%%%%---------%%%%%SSS---
-||-----------|||-------
-||-----------|||-------
|||---------|-|||-------
|||-%%%%%---|-|||-------
|||--|||----|-|||-------