------------------------
------------------------
------------------------
------------------------
------------------------
------------------------
------------------------
------------------------
---------------SSS------
------------------------
-----%%%%%%%S---------SS
------||||--------SS----
%%%%%-||||--------------
--|||-||||--------------
--|||-||||--------------
--|||-||||--------------