------------------------
------------------------
------------------------
------------------------
------------------------
-----o------------------
SS-----------------SS%%%
----------------------||
-----------S----------||
----------------------||
-------------%%%%-----||
--------------||------||
-----------|--||------||
-----------|--||------||
%%--%%%%%--|--||------||
|----|||---|--||-------|