------------------------
------------------------
------------------------
------------------------
------------------------
------------------------
------------------------
------------------------
S--------SSS------------
------------------------
%%%%-------------------%
-||---------------------
-||------------------%%%
-||-------------------|-
--|-%----%%%%%%%------||
--||------||-||-------||