------------------------
------------------------
------------------------
------------------------
------------------------
------------------------
--------SSS-o-----------
-------------ooo------o-
S-----------------------
------------------------
-%%%--------SSSSS--%%%%%
--|-----------------||--
--|-----------------||--
--------------------||--
XXXXXXXXXXX--%%%%---|||-
XXXXXXXXXXX---||----||--