------------------------
------------------------
------------------------
------------------------
------------------------
------------------------
-----------SSS----------
------------------------
----SSSSooo-------------
------------------------
-------------%%%%-------
-----------%|-||--------
-----------||-||--------
-----------|||||--------
%%%%-----%-|||||-%%%%%--
-||--------|||||--|||---