------------------------
------------------------
------------------------
------------------------
------------------------
------------------------
------------SS----------
-----------------------|
SS--------------------%%
-----------------------|
-----%%%%%-------------|
-------||--------------|
-------||--------------|
-------||--------------|
-------||%%%%%--%%%%%%%X
-------||-|||----|||||-X