------------------------
------------------------
------------------------
------------------------
------------------------
------------------------
--S-------SS-------SS---
------------------------
------------------------
------------------------
S--%%%%%%----%%%%-------
----||||------||--------
----||||------||--------
----||||------||--------
----|||%%%%%%%||---%%%XX
----|||-||--|-||----||--