------------------------
------------------------
------------------------
------------------------
------------------------
------------------------
%-----------------------
------------------------
--ooo----%%%------------
----o-----|-------------
--SS------|----%%%---%%%
----------|-----|-----|-
----------|-----|-----|%
----------|-----|-----||
---------||-%%%%|%%%--||
----------|--||-||----||