------------------------
------------------------
------------------------
------------------------
------------------------
--------oooo------------
------SSS---------------
------------------------
----------SS---|--------
---------------|-----SSS
%%%%%-------%%%%--------
-|||---------|||--------
-|||---------|||--------
-|||---------|||--------
-|||--%%%%---||%%%------
-|||---||----||||-------