------------------------
------------------------
------------------------
------------------------
------------------------
------------------------
-------SSooo------------
------------oo----------
-----------------------S
------------------------
%---%%%-----SSS-----%%%-
-----|---------------|--
-----|%%%------------|--
-----|||-------------|--
%%%--|||-------------|--
|----|||-------------|--