------------------------
------------------------
------------------------
------------------------
------------------------
------------------------
---------SSSS-----------
------------------------
------------------------
------------------------
----%%%%---------%%%---%
----|||-----------||%%%%
----|||-----------||-|||
----|||-----------||-|||
%%%%%||%%%%%-----%||||||
|||-|||-|||-------||-|||