------------------------
------------------------
------------------------
-----oooo---------------
--------------------%%%-
-----------ooo-------|--
----SSSS-------------|--
---------------------|--
------------SSS------|%%
---------------------|-|
%--------%-----------|-|
----------%%%%%------|-|
-----------|||-------|-|
-----------|||---------|
%%%%%%%%%--|||---------|
-||||%||---|||---------|