------------------------
------------------------
------------------------
------------------------
------------------------
------------------------
-----------SS-----------
-----o------------------
----------------------SS
------------------------
------------------------
--------%%%%------------
--------%||-------------
---------||-------------
%%%%%%%%%|||%%----%%%%%%
-|||||||-||||------||--|