------------------------
------------------------
------------------------
------------------------
------------------------
------------------------
---------------SSooo----
--------------------oo--
%%%---------------------
-|----------------------
-|----%%%---%%%-----SSS-
-|-----|-----|----------
-|-----|-----|%%%-------
-|-----|-----|||--------
||-%%%%|%%%--|||--------
-|--||-||----|||--------