------------------------
------------------------
------------------------
-oooo-------------------
----------------%%%-----
-------ooo-------|------
SSSS-------------|------
-----------------|------
--------SSS------|%%%---
-----------------|-|----
-----%-----------|-|%%%%
------%%%%%------|-|-||-
-------|||-------|-||||-
-------|||---------||||-
%%%%%--|||---------||||-
|%||---|||---------||||-