------------------------
------------------------
------------------------
------------------------
------------o-----------
------%oooo-%o---o------
------SS----%%%------SSS
-------------|-------S--
---------SSS-|----------
-------------||---------
----SS-------||---------
-------------||---------
-------------|||--------
-------------|||--------
%%%%%--------||||%%%----
-|||---------||||||-----