------------------------
------------------------
------------------------
------------------------
------------------------
------------------------
------------------------
----------|-------------
S-------%%|%-----SSSSSSS
---------||-------------
----SS---||%%%%---------
---------||-||----------
---------|||||----------
---------|||||----------
---------|||||----%%%%--
---------|-|||-----||%--