------------------------
------------------------
------------------------
------------------------
------------------------
------------------------
------------------------
------------------------
---------SSSS-----------
------------------ooSS--
--------------SSS------%
-%%%%%%%----------------
--||||||----------------
--||||||----------------
%-||||||---------%%%----
--||||||----------||----