------------------------
------------------------
------------------------
------------------------
------------------------
------------------------
------------------------
------------------------
------------------------
------------------------
---%%%%--%--------------
%%%-||------------------
|||-||------------------
|||-||------------------
|||-||--%%--XXX--%%%%%%-
|||-||--||--XXXX--|||---