------------------------
------------------------
------------------------
------------------------
------------------------
---------ooo------------
--SSS----------------SS-
------------------------
--------SSS------SS-----
------------------------
------------%%%%%%------
-------SSS---||||-------
-------------||||-------
-------------||||-------
%%%%---------||||-------
-||----------||||-------