------------------------
------------------------
------------------------
------------------------
------------------------
------------------------
-----SSS----------------
------------TT----------
------------TT----------
------------TT----------
-#---SSS----XX-----TT---
-#-----------------TT---
-##----------------TT---
-##---------k------TT---
XXXXXXXXXXXXXXXXXXXXXXXX
XXXXXXXXXXXXXXXXXXXXXXXX