------------------------
------------------------
------------------------
------------------------
------------------------
---------------y--------
---------------##-------
-------------y###-------
-------------####-------
------------#####-------
-----------######---C---
----------#######-------
---------########-------
--------#########-------
XXXXXXXXXXXXXXXXXXXXXXXX
XXXXXXXXXXXXXXXXXXXXXXXX