-----------------------
-----------------------
-----------------------
SSSSSSSSSSSSSSSSSSSSSSS
-----------------------
-----------------------
-----------------oooo--
-----------------------
---------------S-SSSS-U
-----C---------SoS--SoS
-#-------------SSS--SSS
-#-#---#---------------
-#-#---#-#-------------
-#-#-E-#-#--------kk---
XXXXXXXXXXXXXXXXXXXXXXX
XXXXXXXXXXXXXXXXXXXXXXX