-----------------------
-----------------------
-----------------------
-----------------------
-----------------------
-----------------------
--------------SCS------
-----------------------
-----------------------
-----------------------
-SSS------TT---2---TT--
----------TT-------TT--
----------TT-------TT--
----------TT----k--TT--
XXXXXXXXXXXXXXXXXXXXXXX
XXXXXXXXXXXXXXXXXXXXXXX