-----------------------
-----------------------
-----------------------
-----------------------
-----------------------
-----------------------
-----------------------
-----------------------
-----------------------
--------------------1--
--tt---------tt--------
--tt---------tt--------
--tt---------tt--------
--tt-----g-g-tt--------
XXXXXXXXXXXXXXXXXXXXXXX
XXXXXXXXXXXXXXXXXXXXXXX