------------------------
------------------------
------------------------
------------------------
-----------K------------
------------------------
-----------##-----------
----------###-----------
---------####-----------
--------#####-----------
------TT#####-----------
-----#TT#####-----------
----##TT#####--------F--
---###TT#####--------#--
XXXXXXXXXXXXXXXXXXXXXXXX
XXXXXXXXXXXXXXXXXXXXXXXX