------------------------
------------------------
------------------------
------------------------
------------------------
------------------------
-----LSSS---------------
------------------------
-g----------------------
-#----------------------
##---2-----#-----------T
##---------#-----------T
##---------##----------T
##----kk---##---gg-----T
XXXXXXXXXXXXXXXXXXXXXXXX
XXXXXXXXXXXXXXXXXXXXXXXX