-----------------------
-----------------------
-----------------------
-----------------------
-----------------------
------------------k----
-----------------##----
----------------###----
--#-----------k####----
--#-----------#####----
--#----------######----
-##---------#######----
-##--------########----
-##-------#########----
XXX---XXXXXXXXXXXXXXXXX
XXX---XXXXXXXXXXXXXXXXX