------------------------
------------------------
------------------------
-------------U----------
------------------------
------------------------
S-----------------------
---------------SS-------
--------------------#---
-----------SS------##---
S-----------------###---
---#----*--------####---
---#----*-------#####---
---#----*------######---
XXXXXXXXXXXXXX-XXXXXXXXX
XXXXXXXXXXXXXX-XXXXXXXXX