------------------------
------------------------
----#-------------------
----#-------------------
------------------------
-#----------------------
-#----------------------
-#----------------------
----#-------------------
----#--------------XXXXX
----#------TT-----XXXXXX
---##-----otto-----X----
--###-----otto-----X----
--###X-X--otto--X-X-----
XXXXXXXXXXXXXXXXXXXX----
XXXXXXXXXXXXXXXXXXXX----