D-----------------D-----
D-----------------D-----
D-----------------D-----
D-----------------D-----
D-----------------D-----
D-----------------D-----
D--------------D--D-----
D-------------YD--D-----
D-------------DD--D-----
D--------------D--DDDDDD
---------g-g-g-D--------
-----DDDDDDDDDDD--------
----D----------D------oo
---D-----------D-------y
XXXXXXXXXXXXXXXXXXXXXXXX
XXXXXXXXXXXXXXXXXXXXXXXX