-------------U----------
------------------------
-------------D----------
---------------D--------
-------------D----------
---------------D--------
--------D----D----------
-------oD--g--g---------
-------DDDDDDDDD--------
-------D--------D-------
-----------------D------
------*----ooo----D-----
---*--D----o-o-----D----
---D--D----ooo------D--D
XXXXXXXX-------------XXX
XXXXXXXX-------------XXX