------------------------
------------------------
------------------------
------------------------
-----------------oo-----
-----------D------------
------------------------
------------------------
-------TT----XXX----XX--
-------tt----XXX----XX--
---TToott------X--------
---ttoott---X--X--------
---ttoott---X--X--------
---ttggtt------X--------
XXXXXXXXXXXXXXXX--------
XXXXXXXXXXXXXXXX--------