------------------------
------------------------
----------------#-------
----------------#-------
------------------------
-------------#----------
-------------#--------o-
-------------#-------Xo-
----------------#----Xo-
----------------#-XXXXXT
----------------#-XXXXXt
---------oo----##------t
-----#---##---###------t
-gX--#--y--y--###------t
XXXXXXXXXXXXXXXXX------t
XXXXXXXXXXXXXXXXX------t