------------------------
------------------------
------------------------
------------------------
------------------------
------------------------
------------------------
------------------------
-o----------------------
o-o---------------------
-o-o--------o-----------
o-o-o--K----o----------*
---D---D----o-------*--D
-D---D----------k---D--D
XXXXXXXXXXXXXXXXXXXXXXXX
XXXXXXXXXXXXXXXXXXXXXXXX