------------------------
------------------------
------------------------
------------------------
------------------------
------------D-o-------oo
--------------o-------TT
--------------o-------tt
--------TT----o--oo-----
--------tt----o--TT-----
----TToott----o--tt---oo
----ttoott----o-------TT
----ttoott------------tt
----ttggtt--------g---tt
XXXXXXXXXXXXXX---XX-X--X
XXXXXXXXXXXXXX---XX-X--X