------------------------
------------------------
------------------------
------------------------
------------------------
------------------------
------------------------
--------------------o---
--------------------D---
o-------------------D---
o-------o---------------
o-------o----------*----
--------o-------*--D----
D-gD-g------k---D--D-X--
XXXXXXXXXXXXXXXXXXXXXXXX
XXXXXXXXXXXXXXXXXXXXXXXX