------------------------
------------------------
------------------------
------------------------
------------------------
------------------------
------------------------
------------------------
------------------------
---------o--------------
X--------o--------o-----
X--------o--------o-----
X--------o--------o-----
X--------o------------k-
XX-------X-----XXXXXXXXX
XX-------X-----XXXXXXXXX