----D---D------------D--
----D---D------------D--
----D---D------------D--
----D---D------------D--
----D---D------------D--
----D---D------------D--
----D---D------------D--
----D---D------------D--
----D---D------------D--
DDDDD---D------------D--
--------DDDDDDDDDDDDD---
-------------oo--------g
o---oo-----------------#
--Y--y--k--y----y-----##
XXXXXXXXXXXXXXXXXXXXXXXX
XXXXXXXXXXXXXXXXXXXXXXXX