------------------------
------------------------
------------------------
D-----------------------
------------------------
D-----------------------
---------------------o--
--r------------------o--
%%%%%%%--------------o--
%%%%%%%--------------D--
|--------o--------------
|--------o----------*---
|--------o-------*--D---
|-----------g--g-D--D---
|------XXXXXXXXXXXXXXXXX
|------XXXXXXXXXXXXXXXXX