---------D------------D-
---------D------------D-
---------D------------D-
---------D------------D-
---------D------------D-
---------D------------D-
-------o-D------------D-
-------o-D------------D-
-------o-D------------D-
-------D-D------------D-
---------DDDDDDDDDDDDD--
------*-------oo--------
---*--D-----------------
-g-D--D--k--y----y------
XXXXXXXXXXXXXXXXXXXXXXXX
XXXXXXXXXXXXXXXXXXXXXXXX