------------DD----------
-------------D----------
-------------D----------
-------------D----------
-------------D----------
-------------D----------
-----o-------D----------
----o-o------D----------
---o-o-o-----D----------
DDDDDDDDDDD--DDDDDDDDDDD
----------------------D-
-------------o--------D-
---TT--------*----------
---tt--------D----r-----
T--tt---TT--XXXXXXXXXXXX
t--tt---tt--XXXXXXXXXXXX