--------D---------------
--------D---------------
--------D---------------
--------D---------------
--------D---------------
--------D---------------
--------D---------------
--------D---------------
--------D---------------
--------D---------------
DDDDDDDD----------------
oo----------------------
------------------------
---y--------------------
XXXXXXXXX----D--y---D---
XXXXXXXXXXX---TTXXTT--XX