-D------------D-D-------
-D------------D-D-------
-D------------D-D-------
-D------------D-D-------
-D------------D-D-------
-D------------D-D-------
-D------------D-D-------
-D------------D-D-------
-D------------D-D-------
-D------------D-D-------
-DDDDDDDDDDDDD--DDDDDDDD
------oo-------------oo-
------------------------
-k--y----y------k--y----
XXXXXXXXXXXXXXXXXXXXXXXX
XXXXXXXXXXXXXXXXXXXXXXXX