------------------------
------------------------
------------------------
------------------------
------------------------
------------------------
------------------------
------------------------
---o--o-----------------
---o--o------------o----
-------------------o----
---!--!------------o----
-------------------o----
--------g-g--------o----
XXXXXXXXXXXX-------X----
XXXXXXXXXXXX-------X----