----D-------------------
----D-------------------
----D-------------------
----D-------------------
----D-------------------
----D-------------------
----D-------------------
----D-------------------
----D-------------------
----D-------------------
DDDD--------------------
------------------------
------------------------
------------------------
XXXXX----D--y---D-------
XXXXXXX---TTXXTT--XXXX--