------------------------
------------------------
------------------------
------------------------
------------------------
------------------------
------------------------
------------------------
------------------------
------------------------
------------------------
------C-S-S-C-----------
---------------D-----*--
------ooo------D-----D--
XXX--XXXXX-XXXXXXXXXXXXX
XXX--XXXXX-XXXXXXXXXXXXX