----------------D-------
----------------D-------
----------------D-------
-------X--gX-g--D-------
XXXXXXXXXXXXXX--D*------
XXXXXXXXXXXXXX--DD------
-------------X--D-------
-------------X----------
-------------------k----
----------------XXXXXXXX
-D-D-DD--D-D-DD-XXXXXXXX
-D-D-D-D-D-D-D----------
-DD--DD--D-D-DD---------
-D-D-D-D--D---D---------
-D-D-D-D--D--DD---------
------------------------