------------------------
------------------o-----
------------------------
---X--gX-g----#---y---#-
XXXXXXXXXX-#############
XXXXXXXXXX--------------
---------X-#---y-----y--
---------X-#############
------------------------
-----------#---y-----y--
-DD--D-D-DD#############
-D-D-D-D-D--------------
-DD--D-D-DD-------------
-D-D--D---D-------------
-D-D--D--DD-------------
------------------------