-------D---D------------
-------D---D------------
-------D---D------------
-------D---D------------
-------D---D------------
-------D---D------------
-------D---D------------
-------D---D------------
-------D---D------------
DDDDDDDD---D------------
-----------DDDDDDDDDDDDD
----------------oo------
-ooo---oo---------------
--y--Y--y--k--y----y----
XXXXXXXXXXXXXXXXXXXXXXXX
XXXXXXXXXXXXXXXXXXXXXXXX