------------------------
------------------------
------------------------
------------------------
------------------------
------------------------
------------------------
------------------------
------------------------
------------------------
------------------------
-----------------C-S-S-C
--*-----D---------------
--D-----D--------ooo----
XXXXXXXXXXXXXX--XXXXX-XX
XXXXXXXXXXXXXX--XXXXX-XX