------------------------
------------------------
------------------------
------------------------
------------------------
----oX------------------
----oX---------------o--
----XX---------------o--
XX--XX---------------o--
XX--XX---------------D--
-----X---o--------------
-----X---o----------*---
-----X---o-------*--D---
-----X------g--g-D--D---
-----X-XXXXXXXXXXXXXXXX-
-----X-XXXXXXXXXXXXXXXX-