------------------------
------------------------
------------------------
------------------------
------------------------
------------------------
------------------------
------------------------
XX-----oooo-----g-------
XX-##--####--#####------
----#-y#--#-y#----------
-----##----##-----------
-------------------D----
-------------------D----
------------------XXXXXX
------------------XXXXXX