------------------------
------------------------
------------------------
------------------------
------------------------
X-----------------------
X-----o-----------------
X----Xo-----------------
X----Xo-----------------
X-XXXXXTTXXXXXX---------
X-XXXXXttXXXXXX---------
X------tt---------212222
X------tt-------------oo
X------tt---------g--goo
X------tt-------XXXXXXXX
X------tt-------XXXXXXXX