------------------------
------------------------
------------------------
------------------------
------------------------
------------------------
------------------------
------------------------
------------------------
------------------------
------------------------
------------------------
------------------------
----------------------#-
---D-------D--y---D---X-
XTT--XXXX---TTXXTT--XXX-