-------------------D----
-------------------D----
-------------------D----
-g-----------------D----
XX-----------------D*---
XX-----------------DD---
-X-----------------D----
-X----------------------
-------oooo-----g-----k-
---##--####--#####-XXXXX
-DD-#-y#--#-y#-----XXXXX
-D---##----##-----------
-DD---------------------
--D---------------------
-DD---------------------
------------------------