------------------------
------------------------
----!--!----------------
------------------------
------------------------
----!--!----------------
------------------------
---------k--------------
XXXXXXXXXX--------------
XXXXXXXXXX--------------
------------------------
------------------C-S-S-
------------------------
------------------ooo---
-----------XXXX--XXXXX-X
-----------XXXX--XXXXX-X