------------------------
------------------------
------------------------
------------------------
------------------------
------------------------
------------------------
------------------------
DDDDDDDDD---------------
--------------------o---
--------------------o---
--o--------Y--------o---
--o--------Y--------o---
--o-----Dy-D--------o---
--X-----XXXXX-------X---
--X-----XXXXX-------X---