------------------------
------------------------
------------------------
------------------------
------------------------
------------------------
----o-------------------
---Xo-------------------
---Xo----------XXX--XXXX
XXXXXTTXXXXXX--XXX--XXXX
XXXXXttXXXXXX-----------
-----tt-------X---------
-----tt-------X---------
-----tt---------------g-
-----tt-------XXXX--XXXX
-----tt-------XXXX--XXXX