------------------------
------------------------
------------------------
------------------------
------------------------
------------------------
------------------------
------------------------
------------------------
--------o---------------
--------o-------o-------
--------o-------o-------
X---------------o-------
X---D--gD-gD-g------k---
XXXXXXXXXXXXXXXXXXXXXXXX
XXXXXXXXXXXXXXXXXXXXXXXX