----------D------------D
----------D------------D
----------D------------D
--oo---oo-D------------D
--YY---YY-D------------D
--DD---DD-D------------D
------o---D------------D
------o---D------------D
------o---D------------D
D-----D---D------------D
----------DDDDDDDDDDDDD-
---------------oo-------
------------------------
----------k--y----y-----
---------XXXXXXXXXXXXXXX
---------XXXXXXXXXXXXXXX