------------------------
------------------------
----!--!----------------
------------------------
------------------------
----!--!----------------
------------------------
---------k--------------
XXXXXXXXXX--------------
XXXXXXXXXX--------------
------------------------
------------------------
------------D-----*-----
------------D-----D-----
-----------XXXXXXXXXXXXX
-----------XXXXXXXXXXXXX