------------------------
------------------------
------------------------
------------------------
------------------------
------------------------
------------------------
------------------------
--------o---------------
##-----o-o--------------
------o-o-o--------o----
-----o-o-o-o-------o----
--D-----|-------D--o----
--X-k---|----k--X-----g-
--XXXXXXXXXXXXXXXXXXXXXX
--XXXXXXXXXXXXXXXXXXXXXX