------------------------
L-----------------------
------------------------
------------------------
%-----------------------
%-----------------o-----
------------------o-----
------------------o-----
%-----------------o--oo-
%---------o-------o--TT-
----------o-------o--tt-
----------o-------o-----
----------o-------------
----------o-----------g-
--X-------X-----XX---XX-
--X-------X-----XX---XX-