------------------------
------------------------
------------------------
------------------------
------------------------
------------------------
------1-----------------
-------------------oooo-
------------------------
------------------------
----QQQQ----------------
-----------------#------
-----------------#------
-----yy----------#------
XXXXXXXXXXXXXXXXXXXXXXXX
XXXXXXXXXXXXXXXXXXXXXXXX