------------------------
------------------------
------------------------
------------------------
------------------------
------------------------
--%%%%------------------
---||--------------SSS--
---||------SSS-oo-------
---||-------------------
SS-||%%%%%-----SS-------
---||-|||---------------
---||-|||---------------
---||-|||---------------
--%%%%|||---------------
---||-|||---------------