------------------------
------------------------
------------------------
------------------------
------------------------
------------------------
-------------------SUS--
------------------------
------------------------
------------------------
------------------#####-
------------------#-----
-----------------K#-----
---ggg------------#-----
XXXXXXXXXXXXXXXXXXXXX---
XXXXXXXXXXXXXXXXXXXXX---