------------------------
------------------------
------------------------
------------------------
------------------------
------SSS---------------
------------------------
----g----------o----ooo-
%%%%%%------------------
-||||----SSS------------
-||||----------------%%%
%||||-----------------||
-||||-----------------||
-||||----oo---%%%%%%%-||
-||||---%%%----|||||--||
-||||----|-----|||||--||