------------------------
------------------------
------------------------
------------------------
------------------------
------------------------
-----------------------S
------------------------
------------------------
------------------------
----------------------##
----------------------#-
---------------------K#-
-------ggg------------#-
XXXXXXXXXXXXXXXXXXXXXXXX
XXXXXXXXXXXXXXXXXXXXXXXX