------------------------
------------------------
------------------------
------------------------
------------------------
------------------------
----------------oo---%%%
-------SSS------SS----||
----------------------||
----------------------||
%%-----------------SS-||
|---------------------||
|---------------------||
|---------------------||
|-%%%%%%----%%%%-----%%%
|--||||------||-------||