------------------------
------------------------
------------------------
------------------------
------------------------
------------------------
------------------------
------------------------
------------------------
---------------------SSU
#-----------------------
#-------K---------------
#-----------K-----------
#-----------------------
XXXXXX-X-XX-X-XX-XXXXXXX
XXXXXX-X-XX-X-XX-XXXXXXX