------------------------
------------------------
------------------------
------------------------
------------------------
------------------------
------------------Q-----
------------------------
------------------------
------------------------
------------------?-----
--------------TT--------
--------------TT--------
--------------TT--------
XXXXXXXXXXXXXXXXXXXXXXXX
XXXXXXXXXXXXXXXXXXXXXXXX