------------------------
------------------------
------------------------
------------------------
------------------------
------------------------
----USSS----------------
------------------------
------------------------
--E------TT-------------
-TT------TT-------------
-TT--tt--TT-------------
-TT--tt--TT-------------
-TT--tt--TT-----k-------
XXXXXXXXXXXXXXXXXX---XXX
XXXXXXXXXXXXXXXXXX---XXX