------------------------
------------------------
------------------------
------------------------
------------------------
------------------------
SSSS---SSS!-------------
------------------------
------------------------
------------------------
----------C-----SU----!-
------------------------
------------------------
-----------g-g--------k-
XX---XXXXXXXXXXXXXXXXXXX
XX---XXXXXXXXXXXXXXXXXXX