------------------------
------------------------
------------------------
SSSSSSSSSSSSSSSS-------S
------------------------
------------------------
-----------------------S
------------------------
-------------------SSS--
------------------------
-----------TT----------S
--------#--TT--##-------
-------##--TT--##-------
----kk-##--TT--##-------
XXXXXXXXX--XX--XX------X
XXXXXXXXX--XX--XX------X