----D-----------------D-
----D-----------------D-
----D-----------------D-
----D-----------------D-
----D-----------------D-
----D-----------------D-
----D--------------D--D-
----D-------------YD--D-
----D-------------DD--D-
----D--------------D--DD
DDDD---------g-g-g-D----
---------DDDDDDDDDDD----
--------D----------D----
-------D-----------D----
XXXXXXXXXXXXXXXXXXXXXXXX
XXXXXXXXXXXXXXXXXXXXXXXX