------------------------
------------------------
------------------------
------------------------
------------------------
------------D-----------
------------------------
------------------------
--------TT---------o----
--------tt--------o-o---
----TToott-------o-o-o--
----ttoott------o-o-o-o-
----ttoott---D-----|----
----ttggtt---X-k---|----
XXXXXXXXXXXXXXXXXXXXXXXX
XXXXXXXXXXXXXXXXXXXXXXXX