--------------DDDDDDD---
--------------------D---
--------------------D---
--------------------D---
----oo--------------D---
-----------oX--X--ooD---
-----------oX--X--ooD---
-----------XX--X---o----
XXX----XX--XX--X---o----
XXX----XX--XX--X--------
--X---------X--X--------
--X---------X--X--------
--X---------X--X--------
--X---------X--X--------
XXX---------X--X---DD---
XXX---------X--X--------