------D------------D-D--
------D------------D-D--
------D------------D-D--
------D------------D-D--
------D------------D-D--
------D------------D-D--
------D------------D-D--
--D---D------------D-D--
------D------------D-D--
DDD---D----oo-----oD-DDD
D---X-D-----------*D----
D---X-Do---TT-----------
--o-X-D*---tt--oo-------
--*-X------tt-----------
XXXXXXXXX--tt--TT-XX--TT
XXXXXX-----tt--tt---X-tt