-----DD--------D--------
-----DD--------D--------
-----DD--------D--------
-----DD--------D--------
-----DD--------D--------
-----DD--------D--------
-----DD--------D*-------
-----DD-----------------
-----DD--------X*-------
XX---DD----XX--XX*------
XX---DD----XX--XXXXXXXXX
D----------D------------
D---------*D------------
D*--oooo--D-------------
-DDDDDDDDD--------------
------------------------