------------------------
------------------------
------------------------
------------------------
------------------------
------------------------
------------------------
------------------------
------------------oooo--
-------------X##--####--
-----TT-----XX-#-y#--#-y
----otto-----X--##----##
----otto-----X----------
-X--otto--X-X-----------
XXXXXXXXXXXXXX----------
XXXXXXXXXXXXXX----------