------------------------
------------------------
------------------------
------------------------
------------------------
-----------D------------
----------------------TT
----------------------tt
-------TT-------g-g---tt
-------tt---XXXXXXXTTXXX
---TToott---XXXXXXXttXXX
---ttoott----------tt---
---ttoott----------tt---
---ttggtt----------tt---
XXXXXXXXXXXX-------tt---
XXXXXXXXXXXX-------tt---