------------------------
------------------------
------------------------
------------------------
-----g------------------
---DDD--------------D-o-
-TTDD-----------------o-
-tt-------------------o-
-tt-------------TT----o-
XXXXXX----------tt----o-
XXXXXX------TToott----o-
------------ttoott----o-
------------ttoott------
------------ttggtt------
------XXXXXXXXXXXXXXXX--
------XXXXXXXXXXXXXXXX--