---DD--------------D----
----D--------------D----
----D--------------D----
----D--------------D----
----D--------------D----
----D--------------D----
----D--------------D----
----D----------D---D----
----D--------------D----
XX--DDDDDDDDDDDD---D----
XX-----------D---X-D----
----o--------D---X-Do---
----*----------o-X-D*---
----D----r-----*-X------
---XXXXXXXXXXXXXXXXXXX--
---XXXXXXXXXXXXXXXX-----