---------DD-------DD----
---------DD--------D----
---------DD--------D----
---------DD--------D----
---------DD--------D----
---------DD--------D----
---------DD--------D----
--o------DD--------D----
--D------DD--------D----
--D-XX---DD----XX--DDDDD
----XX---DD----XX-------
-*--D----------D---o----
-D--D---------*D---*----
-D--D*--oooo--D----D----
XXX--DDDDDDDDD----XXXXXX
XXX---------------XXXXXX