-------------DD--------D
-------------DD--------D
-------------DD--------D
-------------DD--------D
-------------DD--------D
-------------DD--------D
-------------DD--------D
------o------DD---------
------D------DD--------X
------D-XX---DD----XX--X
--------XX---DD----XX--X
-----*--D----------D----
--*--D--D---------*D----
--D--D--D*--oooo--D-----
XXXXXXX--DDDDDDDDD------
XXXXXXX-----------------