------------------------
------------------------
------------------------
------------------------
------------------------
-----------------------D
--------o---------------
--------o---------------
--------o----------TT---
--------D----------tt---
---------------TToott---
-------*-------ttoott---
----*--D-------ttoott---
--g-D--D-------ttggtt---
XXXXXXXXXXXXXXXXXXXXXXXX
XXXXXXXXXXXXXXXXXXXXXXXX