------------------------
------------------------
------------------------
------------------------
------------------------
-----------------X------
-----------------X------
--D-------------XX------
----XXX--XXXXX-XXX----o-
D---XXX--XXXXX-XXX----#-
----------------oX---##-
--DX------------oX--###-
--DX------------oXo-###-
--D--------g----oX#-###-
XXXXXXX--XXXXX-XXXX-XXX-
XXXXXXX--XXXXX-XXXX-XXX-