------------------------
------------------------
------#-----------------
------#-----------------
------------------------
---#-----------------D--
---#--------------------
---#--------------------
------#----------TT-----
------#----------tt-----
------#------TToott-----
o----##------ttoott-----
#---###------ttoott-----
-y--###------ttggtt-----
XXXXXXXXXXXXXXXXXXXXXXXX
XXXXXXXXXXXXXXXXXXXXXXXX