------------------------
------------------------
------------------------
------------------------
-o-*D-------------------
-D--D-------------------
----D-------------------
----D-------------------
----D-------------------
---*D------------------g
----D-------o-----*D---#
----D-------o----ooD-g##
----Do------o----DDD-###
----Do------g-----*D####
X---XX------X-----XXXXXX
X---XX------X-----XXXXXX