------------------------
------------------------
--------------------#---
--------------------#---
------------------------
-----------------#------
-----------------#------
-----------------#------
--------------------#---
-----X--------------#---
----XX--------------#---
-----X-------oo----##---
-----X---#---##---###---
--X-X-X--#--y--y--###---
XXXXXXXXXXXXXXXXXXXXXXXX
XXXXXXXXXXXXXXXXXXXXXXXX