------------------------
------------------------
---------------#--------
---------------#--------
-----------------DDD----
------------#----DDD----
------------#------D----
------------#---D---Dg--
---------------#-----D--
---------------#------Do
---------------#------Do
--------oo----##------Do
----#---##---###-------D
-X--#--y--y--###--------
XXXXXXXXXXXXXXXX--------
XXXXXXXXXXXXXXXX--------