------------------------
------------------------
------------------------
------------------------
--------------------gDD-
------------------DDD---
----------------TTDD-D*-
-----o----------tt------
-----D----g-g---tt---D*-
-----DXXXXXXXTTXXXXXX---
------XXXXXXXttXXXXXXD*-
----*--------tt---------
-*--D--------tt---------
-D--D--------tt---------
XXXXXX-------tt---------
XXXXXX-------tt---------