--D----D----------------
--D----D----------------
--D----D----------------
--D----D----------------
--Do--oD----------------
--Do--oD----------------
------------------------
------------------------
#y-#--#y-#--------------
####--####----------o---
--------------------o---
--------------------o---
--------------------o---
--------------------o---
------------X-------X---
------------X-------X---