------------------------
------------------------
----------------------YY
----------------------DD
------------------------
---------D--------------
----------------------D-
----------------------o-
-----TT-------ooo-----o-
-----tt----DD-DDDD-DDDDD
-TToott-----------------
-ttoott-----------------
-ttoott-----------------
-ttggtt-----------------
XXXXXXXXXX--------------
XXXXXXXXXX--------------