------------------------
------------------------
-----------------------Y
-----------------------D
------------------------
----------D-------------
-----------------------D
-----------------------o
------TT-------ooo-----o
------tt----DD-DDDD-DDDD
--TToott----------------
--ttoott----------------
--ttoott----------------
--ttggtt----------------
XXXXXXXXXXX-------------
XXXXXXXXXXX-------------