-----------------------
-----------------------
-----------------------
-----------------------
-----------------------
-----------------------
------y----------------
----#SSS---------------
---##------------------
--###1--------------ooo
--###------------------
#-###--SSS-------TT----
#-###------------TT----
--###---------y--TT----
XXXXXXXX---XXXXXXXXXXXX
XXXXXXXX---XXXXXXXXXXXX