-----------------------
-----------------------
-----------------------
-----------------------
-----------------------
-----------------------
----------SCS----------
-------------------TT--
-------------------TT--
-------------------XX--
------TT---2---TT------
------TT-------TT------
------TT-------TT-----T
------TT----k--TT-----T
XXXXXXXXXXXXXXXXXXXXXXX
XXXXXXXXXXXXXXXXXXXXXXX