-----------------------
-----------------------
-----------------------
-----------------------
-----------------------
-----------------------
--SCS------------------
-----------TT----------
-----------TT----------
-----------XX----------
---2---TT--------------
-------TT-------------K
-------TT-----TTTT-----
----k--TT-----TTTT-----
XXXXXXXXXXXXXXXXXXXXXXX
XXXXXXXXXXXXXXXXXXXXXXX