-----------------------
-----------------------
-----------------------
-----------------------
-----------------------
-----------------------
-----------------------
-----------------------
-----------------------
-----------------------
---SSS---------TT------
-----K---TT----TT------
---------TT----TT------
--K------TT---gTT------
XXXXXXXXXXXXXXXXXXXXXX-
XXXXXXXXXXXXXXXXXXXXXX-