------------------------
------------------------
------------------------
------------------------
------------------------
------------------------
-----SSo-----SSSS-------
------------------------
---SS-------------------
------------------------
--------%%%%-----------S
---------||-------------
---------||%------------
---------|||------------
XXXX-----|||-%%%%%%-----
XXXX-----|||--||||------