------------------------
------------------------
------------------------
---------------o--------
------------------------
--------------------oooo
SS----------SSSSSSSS----
-------ooo--------------
----SSS----------------S
------------------------
----------SS--SS--------
--------------------|---
----------------%%%%|---
-----------------||||---
%%%%%------------||||%%%
||||-------------||||-||