------------------------
------------------------
------------------------
------------------------
------------------------
------------------------
SS-----------SSS----SSSS
------------------------
o----%%%----------------
%----||-----------------
-----||---------SS-----%
-----||-----------------
------||----------------
------||----------------
------||----------------
------||----------------