------------------------
------------------------
------------------------
------------------------
------------------------
------------------------
o--------SSS------------
--oooo------------------
-------------------SSooo
------------------------
%%SSSS-%%%%%%%---------%
|-------|||||-----------
|-------|||||-----------
|-------|||||-----------
|-------|||||-%%%-------
|-------|||||-||--------