------------------------
------------------------
------------------------
----oo------------------
------------------------
-----------------o------
----SS------SS----------
------------------------
-ooo-------------------S
------------------------
SSS----%%%%-------------
--------||oo------------
--------||-------------|
--------||-------------|
-------%%%%%%%--%%%%%--|
--------|||||----|||---|