------------------------
------------------------
------------------------
------------------------
------------------------
------------------------
------------------------
--|---------------------
-%%%------o-------SS----
--|---------------------
--|%%%-----------------S
--|-|------%%%%%%%------
--|---------|||||-------
--|---------|||||-------
%%XXXXXXX-%%|||||%%%%%%%
|-XXXXXX----|||||-||||||