------------------------
------------------------
------------------------
----------------oooo----
------------------------
-----------------------o
SS%%%%----------SSSS----
---||-------------------
---||-----------------S-
---||-------------------
---||------%%%----------
---||-------|-----------
---||-------|-----------
---||-------|-----------
---|||%%%%--|-%%%%XXXXXX
----|||||---||-||||XXXXX