------------------------
------------------------
------------------------
------------------------
------------------------
------------------------
----SS------------------
----------||------o-----
----------||------------
----------||------------
%---------|||-----------
----------||---------%%%
----------|||--------%||
----------|||---------||
|------%%-||%%%%%%%%%%||
-------||-|||-|||||||-||