------------------------
------------------------
------------------------
------------------------
------------------------
------------------------
------SSSS--------------
--------S---------------
--------------%%%%------
---------------||-------
--------------|||-------
--------------|||-------
--------------||||------
--------------||||------
%%-----%%%----|||%%%%---
|------||------|||-|----