------------------------
------------------------
------------------------
------------------------
------------------------
------------------------
-------------------%%%%%
--------------------||--
----S---------------||-|
--------------S-----||-|
%-------------------||--
--------------------||--
-------%%%%---------||--
--------||----------||--
--------||---%%%%---||--
--------||----||----||--