------------------------
------------------------
------------------------
------------------------
------------SS----------
------------------------
--------SS--------------
------------------------
S-----------------------
------------------------
-------------S%%%%%%%%%-
---------------||||-||--
---------------||||-||--
-----------------||-||--
------%%%%%%%--%%|||||%%
-------|||-------||-||-|