------------------------
------------------------
------------------------
------------------------
------------------------
-----------------------|
---%%%%%----------------
----|||-----------------
----|||-----------------
----|||-----------------
SSS-|||------SS---------
----|||%%%--------------
----||||||--------------
-----|||||-------------X
-----|||||--%%%%%--XXXXX
-----|||||---|||---XXXXX