------------------------
------------------------
------------------------
------------------------
-S%%%%------------------
----|-------------------
----|------%%%%%--------
----|-------|||---------
SS--|-------|||----SS---
----|-------|||---------
----%%%%%---|||---------
------||-----%%%%%%%%%--
------||------|||||||---
------||------||||||||--
%----|||------||||-|||-X
-----|||------||||-|||-X