------------------------
------------------------
------------------------
------------------------
------------------------
-----------o------------
------------------------
-----------------oo-----
-----------SSSSS--------
------------------------
%---------------%%%%----
-----------------|------
-----------------|------
----------------||------
-X----%%%%%%%%%-||-%%%--
-XXX---||-|-|----|-||---