------------------------
------------------------
------------------------
------------------------
------------------o-----
-------------ooooo------
SS---------SSS------SSSS
------------------------
-|--------------SS------
-|----------------------
-%%%%%%-----------------
--||||------------------
--|||-------------------
--||||------------------
-%||||%%%%%%%%%---------
--||||-|||||||----------