------------------------
------------------------
------------------------
------------------------
------o-----------------
------------------------
------------%%-------SSS
------------|-----------
------------|-----------
---%--------|-----------
%%%%--------|-%%%%%-----
-||-------------|-------
|||---------------------
|||---------------|-----
|||-----------%%--|-----
|||---------------|-----