------------------------
------------------------
------------------------
------------------------
------------------------
------------------------
------------------SSSS--
------------------------
------------%%%%--------
-------------||---------
%-------%%%%|||---------
---------|---||---------
---------|---||---------
---------|---|||--------
--%%--%%%%%|||||%%%%%%%%
--|%---|||-||||--||||||-