------------------------
------------------------
------------------------
------------------------
--o---------------------
oo----------------------
----SSSSSSS%%%----------
------------|-----------
SS----------|------SS---
------------|-----------
--------SSSS---S--------
------------------------
------------------------
------------------------
-------------------%%%%%
--------------------|||-