------------------------
------------------------
------------------------
------------------------
------------------------
---------------------ooo
------------------SSSS--
------------------------
SS----------------------
------------------------
--------%%%-%%%%%-------
---------|---%%%%-------
---------|---|||--------
---------|---|||--------
--------%%%%-|||%%%%----
---------||--|||-||-----