------------------------
------------------------
------------------------
------------------------
------------------------
------------------------
SS------SSS-------------
S-----------------------
-----------------S---%%%
----------------------||
----%%%--------------|||
-----|-----------SS--|||
-----|---------------|||
-----|---------------|||
-----|%%%%%%---------|||
-----||-|||----------|||