-----------------------
-----------------------
-----------------------
-----------------------
-----------------------
-----------------------
-----------------------
---oo------------------
--------------%%%------
---------------|-------
-%%%%%---%%%%%%|-------
-||||------|||-|-------
-||||------|||||-------
-|||||-----||--|-----X-
%|||||-----||--|XXXXXXX
-|||||-----||--|XXXXXXX