------------------------
------------------------
------------------------
------------------------
------------------------
-----------------o------
SSSS-------SSS----------
------------------------
---------------S---%%%%-
-------------------%||--
------%------------|||--
%%%%%%-------------|||--
-|||||-------------|||--
-|||||-------------|||--
-|||||----XXXXXXXX-|||-%
-||-||---XXXXXXXX--|||-|