------------------------
------------------------
------------------------
------------------------
------------------------
------------------------
------------------------
oo----------------------
------ooo---------------
-------S---------ooo----
SSSSS------%%%%%-S%%--%%
------------||----|---||
------------||----|---||
------------||----|---||
------------||----%%%-||
------------||----||--||