------------------------
------------------------
------------------------
------------------------
------------------------
-----------------------o
--------------%%%---SSS-
---------------|--------
---------SS----||-------
---------------||-------
%---%%%%-------||-----%%
|--%-||--------||------|
|----||--------||---%%-|
|----||--------||----|-|
|%%%%XXXX------||%%%%|||
|-|X|XXX-------||-||-|||