------------------------
------------------------
------------------------
--oo--------------------
------------------------
------------------------
------------------------
------------------------
----------------S-------
------------------------
%%%%----%%%%%-----------
-||------|||------------
-||------|||-------%%%%-
-||-----||||--------||--
-||-%%%%||||--------||--
-||--|--||||--------||--