------------------------
------------------------
------------------------
------------------------
------------------------
------------------------
----SSS----------------S
------------------------
---------------SS-------
------------------------
%%%---%%%%--------------
-|----------------------
-%%%%%------------------
-||||-------------------
-||||-||XXXXX-XXX---XXXX
-||||-||XXXXXX-XX---XXXX