-----------------------
-----------------------
-----------------------
--------SSoo-----------
-----------%-----------
--------------ooo------
---%-------SSS---------
-----------------------
-----------------------
-----------------------
%%%%%%-----------------
-||||------------------
-||||------------------
-||||----------------X-
-||||----%%%%------XXXX
-||||-----||-------XXXX