------------------------
------------------------
------------------------
------------------------
------------------------
------------------------
---------------------%%%
----------------------|-
-----SSS--------------|-
----------------------|-
-------------------%%%%%
--------------------||||
-----------------%%%||||
------------------|-||||
%----%%%%%%%------||||||
------||-||-------||||||