------------------------
------------------------
------------------------
------------------------
------------ooo--%%-----
----------o------||-----
-----------------||-----
-----------------||-----
oo-------------S-||-----
-----------------||-----
%%%--------------||-----
-||--------------|------
-||-%%%%---------|------
-||--||----------|-----X
-||%%|%%%-%%%%%%%|XXXXXX
-||--|||---|||||-|-XXXXX