------------------------
------------------------
------------------------
------------------------
------------------------
------------------------
------------------------
--------------------o---
------------------------
----ooSS----------------
SSS------%%%%%%%--S-----
----------||-||---------
----------||-||---------
----------||-||---------
---%%%----||-||-%-------
----||----||-||---------