------------------------
------------------------
------------------------
------------------------
------------------------
------------------------
-S%%%------S-----SSS----
---|--------------------
---|--------------------
------------------------
%%%%-%%%%%----------SS--
-||-%%%||---------------
-||--||||---------------
-||--||-|---------------
%%%%|||-|XXXX---%-------
-|||-||-||XXX-----------