------------------------
------------------------
------------------------
------------------------
------------------------
------------------------
-----------------SSSS---
------------------------
-----SSS----------------
------------------------
%%----------%%%%%%------
|------------||||-------
||-----------||||-------
||-----------|||||------
|||----------|||||----%%
|||----------|||||-----|