------------------------
------------------------
------------------------
------------------------
------------------------
------------------------
------------SSSS--------
------------------------
------%%%%---------S----
-------||---------------
--%%%%|||---------%%%%--
---|---||----------||---
---|---||----------|||--
---|---|||---------|||--
%%%%%|||||%%%%%%%%-||||-
-|||-||||--||||||--||||-