------------------------
------------------------
------------------------
------------------------
------------------------
------------------------
--SS--------------SS----
------------------------
------------SSSooo---SSS
------------------------
SS----%%%%%%------%-----
-------||||--------||%--
-------||||--------||---
-------||||--------||---
%%%%%%%||||%%%%%%%-||---
-||||--||||-|||||--||---