------------------------
------------------------
------------------------
---o--------------------
------------------------
------------------------
%------------Soo--------
----------------Sooo----
|----------S------------
-----------SSS----------
|%%%%-----------%%%%--%%
|-|--------------||----|
|-|--------------||----|
|----------------||----|
||||XXXXXXXX----%|-----|
|-||XXXXXXX------|-----|