------------------------
------------------------
------------------------
------------------------
------------------------
------------------------
%-----------------------
----------ooo-----------
-------SSSS-------------
---------------oo-------
%%%%%-------------------
-|||--------------------
-|||--------------------
||||--------------------
||||---------%%%%%%--%%-
||||----------||||---|--