------------------------
------------------------
------------------------
------------------------
------------------------
------------------------
------------------------
-----------ooooo--------
SSooo-------------------
------o-----------------
----%%%-----%%%%-%%-----
-----|-------||---------
-----|-------||-%%%-----
-----|-------||--||-----
-----|---%%%%%%-|||-----
-----|----||%|---||-----