------------------------
------------------------
------------------------
------------------------
------------------------
------------------------
-----------SS-----------
------------------------
%%%------------------SS-
-|----------------------
-|%%%%%--%%%%-----------
-|||||----||------------
--||||----||------------
--||||----||------------
--||||-%%%%%%-----------
--||||--|||||-----------