------------------------
------------------------
------------------------
------------------------
------------------------
------------------------
SS-----------------%%%%-
--------------------||--
--------------------||--
--------------------||--
--------------------||--
--------------------||--
--------%%%%---------|--
---------||----------|--
---------||-%%%%%%%%%%%%
---------||----|||||-|-|