-------------------D----
-------------------D----
---------------YYY-D----
---------------DDD-D----
-----------------D-D----
--D--------------D-D----
---------------D-D-D----
---------------o-D-D----
-------ooo-----o-D-D----
----DD-DDDD-DDDDDD-DDDDD
------------------------
------------------------
------------------------
------------------------
XXX-----------------TT--
XXX---------------X-tt--