----------------
----------------
----------------
--------o--o----
----------------
----------------
--------#-------
------g##-------
------###-------
----g####-------
D---#####-------
D-g######-------
D-#######-------
D########----#--
XXXXXXXXXXXXXXXX
XXXXXXXXXXXXXXXX