------------------------
------------------------
------------------------
------------------------
------------------------
------------------------
------------------------
------------------------
------------------------
------------------------
---------------o--------
-----C-S-S-C---o--------
---------------o-------*
-----ooo-----------k---D
XX--XXXXX-XXXXXXXXXXXXXX
XX--XXXXX-XXXXXXXXXXXXXX