------------------------
------------------------
------------------------
------------------------
------------------------
------------------------
------o-----------------
-----o-o----------------
----o-o-o---------------
DDDDDDDDDDDD--------o---
--------------------o---
--------------------o---
----TT--------------o---
----tt-------D------r---
TT--tt---TT--XXX----D---
tt--tt---tt--XXX--------