------------------DD----
-------------------D----
-------------------D----
-------------------D----
-------------------D----
--D----------------D----
--------o----------D----
-------Xo----------D----
-------Xo----------D----
----XXXXXTTXXXXXX--DDDDD
----XXXXXttXXXXXX-------
---------tt--------o----
---------tt--------*----
---------tt--------D----
XXX------tt-------XXXXXX
XXX------tt-------XXXXXX