------------------------
------------------------
------------------------
------------------------
------------------------
------------------------
--------------------oo--
-----------SSS------SS--
------------------------
------------------------
%%%%%%-----------------S
-||||-------------------
-||||-------------------
-||||-------------------
-||||-%%%%%%----%%%%----
-||||--||||------||-----