------------------------
------------------------
------------------------
-------------------oo---
------------------------
---------ooor---------%%
--------%%%%%----------|
---------|||-----------|
---------|||-----------|
---------|||-----%%%%%-|
------%%%%%%%%----|||--|
-------||||||-----|||--|
-------||||||--o--|||--|
%%%%---||||||-%%%-|||--|
-||----||||||--|--|||--|
-||----||||||--|--|||--|