------------------------
------------------------
------------------------
------------------------
------------------------
------------------------
------------------------
------------------------
------------------------
----------------------o-
------------------------
------------------------
------------------------
-k---------------k------
XXXX-X-XX-XX-XX-XXXXXXXX
XXXX-X-XX-XX-XX-XXXXXXXX