------------------------
------------------------
------------------------
------------------------
------------------------
-------oo--oo-----------
o-----------------------
--------------------r---
------------------%%%%%%
SS-----------------|||||
--------SS---------|||||
-------------------|||||
------------%%%%---|||||
-------------||----|||||
-------------||----|||||
-------------||----|||||