------------------------
------------------------
------------------------
------------------------
------------------------
------------------------
------------------------
-------------------SSS--
------------------------
-oooo-------------------
--------%%%%%%----------
---------||||-----------
---------||||-----------
---------||||-----------
%%%-%%%%-||||-%%%%%%----
||---||--||||--||||-----