------------------------
------------------------
------------------------
SSSSSSSSSSSSSSSSSSSSSSSS
----------SS--SSSSSS--SS
----------SS--SSSSSS--SS
o-------SS--------SS---S
--------SS--------SS---S
S-U-----SS--------SS---S
SoS-----SS----ooooSS---S
SSS-----SSSS--SSSSSS---S
----------SS------------
----------SS------------
----------------k--g-g--
XXXXXXXXXXXXXXXXXXXXXXXX
XXXXXXXXXXXXXXXXXXXXXXXX