------------------------
------------------------
------------------------
------------------------
------------------------
------------------------
------------------------
---------------SSS------
------------------------
o-----------------------
----%%%%%%--------------
-----||||---------------
-----||||---------------
-----||||---------------
%%%%-||||-%%%%%%----%%%%
-||--||||--||||------||-