------------------------
------------------------
---------------YYY------
---------------DDD---#--
-----------------D-###--
-----------------D-----#
--D------------D-D-----#
-YD------------o-D------
-DD----ooo-----o-D------
--D-DD-DDDD-DDDDDD------
g-D---------------------
DDD---------------------
--D---------------------
--D---------------------
XXX---------------------
XXX---------------------