----------------------------------------------------------------------------------------------------------------------------------------------------------------------------------------------------------
----------------------------------------------------------------------------------------------------------------------------------------------------------------------------------------------------------
----------------------------------------------------------------------------------------------------------------------------------------------------------------------------------------------------------
----------------------------------------------------------------------------------------------------------------------------------------------------------------------------------------------------------
----------------------------------------------------------------------------------------------------------------------------------------------------------------------------------------------------------
----------------------------------------------------------------------------------------------------------------------------------------------------------------------------------------------------------
----------------------------------------S----------------------S!S--------------------SSS-------S-----!------------------------------------##SSSS-------------------S-------------------------------------
----------------------------------------------------------------------------------------------------------------------------------------------------------------------------------------------------------
---------------------------###------------------------#----------------------------------------------------------------------------------#----------------------------------------------------------------
--------------------------####--#---------------------##--------------------------------------------------------------------------------#####-----------------###-----------------------------------------
------------------------#####---##-----------------#--###-----S!S---------------#--------------------S-S------------------tt-----S------##-##----------------###---------------#--#------#-##-------------
------------------------#####---#------------------##-###----------------------##---------------------------tt------------tt------------##-##---------------####--------------##--#------#-##-------------
------------------------#####---#--------------tt-###--###--------------------###---------------------------tt-------------#-------------#-##--------------#####----------tt-###--#------#-##-------------
---M--------------------######-##-------g-gg---tt####--###------g---------#---###--##------g--g--------------t-----g----------------gg---#--##----------#--#####----------tt#####-#------#-###------------
---XXXXXXXXXXXXXXXXXXXXXXXXXXXXXXXXXXXXXXXXXXXXXXXXXXXXXXXXXXXXXXXXXXXXXXXXXXXXXXXXXXXXXXXXXXXXXXXXXXXXXXXXXXXXXXXXXX---XXXXXXXXXXXXXXXXXXXXXXXXXXXXXXXXXXXXXXXXXXXXXXXXXXXXXXXXXXXXXXXXXX-XXXXXXXXXXXX-X-
----XXXXXXXXXXXXXXXXXXXXXXXXXXXXXXXXXXXXXXXXXXXXXXXXXXXXXXXXXXXXXXXXXXXXXXXXXXXXXXXXXXXXXXXXXXXXXXXXXXXXXXXXXXXXXXXXXXXXXXXXXXXXXXXXXXXXXXXXXXXXXXXXXXXXXXXXXXXXXXXXXXXXXXXXXXXXXXXXXXXXXXXXXXXXXXXXXXXXX-