------------------------
------------------------
------------------------
------------------------
----------------o-------
o----------------------o
----SS---%%%%---SSS----S
----------|||-----S-----
----------|||-----------
----------|||-----------
----------|||-%%------S-
----------|||-||--------
----------|-||||--------
------------||||--------
XXXX--------|||%%%%-----
X-X---------||||||------