------------------------
------------------------
------------------------
------------------------
------------------------
-----------------------o
-----------------------#
----------------------##
----------------------##
-------------------o--##
X-------o-----*D---#--##
X-------o----ooD--##--##
Xo------o----DDD--##--##
Xo------g-----*D#-##--##
XX------X-----XXX-XX--XX
XX------X-----XXX-XX--XX