------------------------
------------------------
------------------------
------------------D-----
-----------------DD-----
------o-------oo--D-----
------o-------TT--D-----
---o--o-------tt--D-----
---2X-o--oo-------D-----
----X-o--TT-------D-----
---oX-o--tt---oo--D-----
---2X-o-------TT--D-----
----X---------tt--D-----
----X-----g---tt--D-X-X-
X-XXXX---XX-X--XX-XXXXXX
X-XXXX---XX-X--XX-XXXXXX