------------------------
------------------------
------------------------
------------------------
------------------------
-----------------------D
------------------------
--------------o--DDDD---
--X-----------2X--------
--X------------XD-------
X-X-----------oX--------
X-X-----------2X--------
X-X------------X--------
X-X-r-----r----X--------
XXXXX--XX-XX-XXXXXXXXXXX
XXXXX--XX-XX-XXXXXXXXXXX