------------------------
------------------------
------------------------
------------------------
------------------------
------------------------
S--------------------SS-
------------------------
---------SS-------------
------------------------
%-------------%%%%%-----
----------------||------
----------------||------
----------------||------
%---------------||%%%%%-
|---------------||-|||--