------------------------
------------------------
------------------------
------------------------
------------------------
------------------------
-------SSS-----%%%%%%---
----------------||||----
--SSS-----------||||----
----------------|%||----
%%--------------||||----
|---------------||||----
|---------------||||----
|---------------||||----
|%%%%%%%%-------||||-XXX
|-|||-||--------||||-XXX