------------------------
------------------------
------------------------
------------------------
--------------oo--------
--------X------------oX-
--------X------------oX-
-------XX------------XX-
XXXXX-XXX-XXX----XX--XX-
XXXXX-XXX-XXX----XX--XX-
-------oX---X---------X-
-------oXX--X---------X-
-------oXX--X---------X-
--g----oX---X---------X-
XXXXX-XXXXXXX---------X-
XXXXX-XXXXXXX---------X-