------------------------
------------------------
------------------------
------------------------
------------------------
------------------------
------------------------
--D-------------o--DDDD-
----X-----------2X------
D---X------------XD-----
----X-----------oX------
--D-X-----------2X------
--D-X------------X------
--D-X-r-----r----X------
XXXXXXX--XX-XX-XXXXXXXXX
XXXXXXX--XX-XX-XXXXXXXXX