------------------------
------------------------
------------------------
------------------------
------------------------
------------------------
------------------------
------------------------
---------o--------------
--------o-o-------------
-------o-o-o------------
X-----o-o-o-o-----------
X--D-----|-------D------
X--X-k---|----k--X------
XXXXXXXXXXXXXXXXXXX-----
XXXXXXXXXXXXXXXXXXX-----