------------------------
------------------------
------------------------
SSSSSSSSSSSSSSSSSSSSSS--
------------------------
------------------------
------------------------
------------------------
------------------------
------------------------
-------------------g##--
------SS-----------###--
T-----SS---------g####--
T-----SS---------#####--
XXXX--XX--XXXXXXXXXXXX--
XXXX--XX--XXXXXXXXXXXX--