------------------------
------------------------
------------------------
------------------------
------------------------
------------------------
---------------------1--
------------------------
------------------------
------------------------
-------------------QQQQ-
------------------------
------------------------
--------------------yy--
XXXXXXX----XXXXXXXXXXXXX
XXXXXXX----XXXXXXXXXXXXX