------------------------
------------------------
------------------------
------------------------
------------------------
------------------------
------------------------
------------------------
------------------------
------------o-----------
------------------------
------------------------
------------------------
-------k---------ggg----
XX-XX-XXXXXXXXXXXXXXXXXX
XX-XX-XXXXXXXXXXXXXXXXXX