------------------------
------------------o-----
------------------o-----
------------------D-----
-----------------D------
----------------D-------
------------------------
-------o--DDDD----------
-------2X---------D-----
--------XD--------D-----
-------oX---------D-----
-------2X---------------
--------X---------------
---r----X------------#--
XX-XX-XXXXXXXXXXXXXXXXXX
XX-XX-XXXXXXXXXXXXXXXXXX