------------------------
------------------------
------------------------
------------------------
------------------------
------------------------
--Q---------------------
------------------------
------------------------
-------------------oo---
--?---------------o--o--
------------------------
------------------------
------------------------
XXXXXXXXX--XXXXXXXXXXXXX
XXXXXXXXX--XXXXXXXXXXXXX