-----------------------
-----------------------
-----------------------
-----------------------
-----------------------
-----------------------
---------Q-Q-----------
-----------------------
-----------------------
-----------------------
---------Q-Q-----------
-----------------------
-----------------------
-------------y---------
XXXXXXXXXXXXXXXXXXXXXXX
XXXXXXXXXXXXXXXXXXXXXXX