-----------------------
-----------------------
-----------------------
-----------------------
-----------------------
-----------------------
----US-----------------
-----------------------
-----------------------
-----------------------
---####--SSC-----------
#####------------------
###--------------------
#------------------y-y-
-----XX--XXXXXXXXXXXXXX
-----XX--XXXXXXXXXXXXXX