------------------------
------------------------
------------------------
------------------------
------------------------
------------------------
------------------------
------------------------
------------------------
---SSUSSSSS-------------
------------------------
------------------------
------------------------
------------------------
XXXXXXXXXXXXXXXX-X-X-XXX
XXXXXXXXXXXXXXXX-X-X-XXX