------------------------
------------------------
------------------------
------------------------
------------------------
------------------------
------------------------
------------------------
------------------------
------------------------
-----------------------Q
------------------------
------------------------
-y----------------------
XXXXXXXXXXX----XXXXXXXXX
XXXXXXXXXXX----XXXXXXXXX