-----------------------
-----------------------
-----------------------
-----------------------
-----------------------
-----------------------
-----------------------
---------------SSS-----
-----------------------
o----------------------
----%%%%%%-------------
-----||||--------------
-----||||--------------
-----||||--------------
%%%%-||||-%%%%%%----%%%
-||--||||--||||------||