-----------------------
-----------------------
-----------------------
-----------------------
-----------------------
-----------------------
-----------------------
-----------------------
-----------------------
SUSSSSS----------------
-----------------------
-----------------------
-----------------------
-----------------------
XXXXXXXXXXXX-X-X-XXXXXX
XXXXXXXXXXXX-X-X-XXXXXX