-----------------------
-----------------------
-----------------------
-----------------------
-----------------------
------g----------------
----SSSSSSSS---SSS!----
-----------------------
---g-------------------
-----------------------
-S@S--------------C----
-----------------------
-----------------------
-------------------g-g-
XXXXXXXXXX---XXXXXXXXXX
XXXXXXXXXX---XXXXXXXXXX