-----------------------
-----------------------
-----------------------
SSSSSSSSSSSSSSSSSSSSSLS
SS------SSSS-----------
SS---g--SSSS-----------
----SS----------oooooo-
----SS-----------------
----SS----------SSSSSS-
oU--SC--g-g-----SSSSSS-
SS--SS--SSSS-----------
-----------------------
-----------------------
-----------------------
XXXXXXXXXXXX---XXXXXXXX
XXXXXXXXXXXX---XXXXXXXX