-----------------------
-----------------------
-----------------------
SSSSSSSSSSSSSSSSSSSSSSS
--------------SS--SSSSS
--------------SS--SSSSS
-oooo-------SS--------S
------------SS--------S
-SSSS-U-----SS--------S
oS--SoS-----SS----ooooS
SS--SSS-----SSSS--SSSSS
--------------SS-------
--------------SS-------
--kk----------------k--
XXXXXXXXXXXXXXXXXXXXXXX
XXXXXXXXXXXXXXXXXXXXXXX