-----------------------
-----------------------
-----------------------
SSSSSSSSSS-------------
-----------------------
-----------------------
------------SSS--------
-----------------------
-----------------------
-----------------SSSSSS
-------g##-------------
-------###-------------
-----g####--SSS--------
-----#####---------r---
XXXXXXXXXX-------XXXXXX
XXXXXXXXXX-------XXXXXX