-----------------------
-----------------------
-----------------------
----------------oo-----
---------?-----%%%%----
----------------||-----
----------------||-----
--ooo------r----||--SSS
-------%%%%%%---||-----
--------||||----||-----
---%%%%-||||ooo-||-----
----||--||||--r-||-----
----||%%%%%%%%%%||-----
%%%-||-||||||||-||-----
||--||-||||||||-||-----
||--||-||||||||-||-----