-----------------------
-----------------------
-----------------------
-----------------------
-----------------------
-----------------------
-Q-Q-------------------
-----------------------
-----------------------
-----------------------
-Q-Q-------------------
-----------------------
-----------------------
-----y-----------------
XXXXXXXXXXXXXXX----XXXX
XXXXXXXXXXXXXXX----XXXX