------------------------
------------------------
------------------------
------------------------
------------------?-----
------------------------
------------------------
------o----ooo------r---
----------------%%%%%%--
SSS--------------||||---
------------%%%%-||||ooo
-------------||--||||--r
-------------||%%%%%%%%%
oo---%%%%%%%-||-||||||||
%%----|||||--||-||||||||
|-----|||||--||-||||||||