------------------------
------------------------
------------------------
------------------------
------------------------
-----------------------S
------------------------
---------------------g--
-----------------%%%%%%-
------------------||||--
------------------||||--
-------------%%%%%||||--
--------------|||-||||--
-M------------|||-||||--
XXXXXXXXXXX---|||-||||--
XXXXXXXXXXX---|||-||||--