-----------------------
-----------------------
-----------------------
-----------------------
-----------------------
-----------------oo--oo
----g----oo------------
%%%%%%-----------------
-||||------------------
-||||-----SS-----------
-||||-------------SS---
-||||------------------
-||||-----------------%
-||||------------------
-||||------------------
-||||------------------