-----------------------
-----------------------
-----------------------
-----------------------
-----------------------
-----------------------
-----------------------
---------------------g-
-----------------%%%%%%
------------------||||-
------------------||||-
-------------%%%%%||||-
--------------|||-||||-
-M------------|||-||||-
XXXXXXXXXXX---|||-||||-
XXXXXXXXXXX---|||-||||-