------------------------
------------------------
------------------------
------------------------
------------------------
------------------------
------------------------
------------------------
------------------------
SSS---------------------
------------------------
------------------------
---------------------#--
-------------------kk#--
XXXXXXXX-X-X-XXXXXXXXXXX
XXXXXXXX-X-X-XXXXXXXXXXX