-----------------------
-----------------------
-----------------------
-----------------------
-----------o-----------
----------%%%----------
-----------|--o------o-
---o---o---|--SSSS-----
%-%%%-%%%--|-----------
---|---|---|---------SS
---|---|---|-----------
---|---|---|-----------
---|---|---|-----%%%%--
---|-r-|---|------||---
%%%%%%%%%%%%%%----||---
|||||||||||||-----||---