-----------------------
-----------------------
-----------------------
-----------------------
-----------------------
-----------------------
----QQQQQ-----------USS
-----------------------
-----------------------
------k----------------
----?QQQQ----------S---
-----------------------
-----------------------
-----------gg----k-ggg-
XXXXXXXXXXXXXXXXXXXXXXX
XXXXXXXXXXXXXXXXXXXXXXX