-----------------------
-----------------------
-----------------------
-----------------------
-----------------------
-----------------------
--------------------USS
-----------------------
-----------------------
-----------------------
-----------------------
-----------------K---*-
------------*--------*-
-M----------*--------B-
XXXXXXXXXXXXXXXXXXXXXXX
XXXXXXXXXXXXXXXXXXXXXXX