------------------------
------------------------
------------------------
------------------------
------------------------
------------------------
------------------------
------------------------
------------------------
-----------------------y
-------------ooo-------#
----------------------##
---------------------###
--y-y---------------####
XXXXXXXX--XXXXXXXXXXXXXX
XXXXXXXX--XXXXXXXXXXXXXX