-----------------------
-----------------------
-----------------------
SSSSSSSSS----------SSSS
-----------------------
-----------------------
--QQ------------CSS----
-----------------------
-----------SSS--2------
---------------2-2-----
--QQ--QQQ---------2----
-----------------------
-----------------------
-----------------------
XXXXXXXXX------XXXXXXXX
XXXXXXXXX------XXXXXXXX