-----------------------
-----------------------
-----------------------
-----------------------
-----------------------
-----------------------
-----------------------
-----------------------
-----------------------
-----------------------
-------------ooo-------
----------------------#
---------------------##
--y-y---------------###
XXXXXXXX--XXXXXXXXXXXXX
XXXXXXXX--XXXXXXXXXXXXX