------------------------
------------------------
------------------------
SSSSSSSSSSSSSSSSSSSSSSSS
--------------SS--SSSSSS
--------------SS--SSSSSS
-oooo-------SS--------SS
------------SS--------SS
-SSSS-U-----SS--------SS
oS--SoS-----SS----ooooSS
SS--SSS-----SSSS--SSSSSS
--------------SS--------
--------------SS--------
--kk----------------k--g
XXXXXXXXXXXXXXXXXXXXXXXX
XXXXXXXXXXXXXXXXXXXXXXXX