------------------------
------------------------
------------------------
------------------------
------------------------
------------------------
------------SSSS--------
------------------------
------SSS---------------
----------------SSSS----
-r----------------------
%%%%%%%-----------------
||||||------------------
||||||------------------
||||||--------------XXXX
||||||--------------XXXX