-----------------------
-----------------------
-----------------------
SSSSSSSSSSSSSSSSSLSSSSS
----SSSS---------------
-g--SSSS---------------
SS----------oooooo-----
SS---------------------
SS----------SSSSSS-----
SC--g-g-----SSSSSS-----
SS--SSSS---------------
-----------------------
-----------------------
-----------------------
XXXXXXXX---XXXXXXXXXXXX
XXXXXXXX---XXXXXXXXXXXX