------------------------
------------------------
------------------------
------------------------
------------------------
------------oo--oo------
----oo------------------
%-----------------------
-----------------------%
-----SSS----------------
-------------SSS--------
------------------------
-----------------%%%%---
------------------||----
------------------||----
------------------||----