------------------------
------------------------
------------------------
------------------------
------------------------
-oo---------------------
%%%%--------------------
-||--o----R-------------
-||-%%%-----------------
-||--|------------------
-||--|-------------r-r--
-||-o|---------%%%%%%%%%
-||%%%%%--------||||||||
-||-|||---------||||||||
-||-|||-----%%%-||||||||
-||-|||------|--||||||||