------------------------
------------------------
------------------------
------------------------
------------------------
----------oooo----------
----------%%%%----------
oo---SSSS--||-----------
-----------||-----------
-----------||-----------
-----------||-------%%%-
---------U-||--------|--
-----------||--------|--
-----------||--------|--
%%%%-----%%%%%-%%%%%-|--
-||-------|||---|||--|--