------------------------
------------------------
------------------------
------------------------
----oo------------------
-----------oX-----------
-----------oX-----------
-----------XX-----------
XXX----XX--XX-----------
XXX----XX--XX-----------
--X---------X---o-------
--X---------X---o-------
--X---------X---o-------
--X---------X-------k---
XXX---------X-XXXXXXXXXX
XXX---------X-XXXXXXXXXX