------------------------
------------------------
------------------------
------------------------
------------------------
------------------------
------------------D-----
-----------------YD-----
-----------------DD-----
DDD---------------D---g#
------------g-g-g-D---##
--------DDDDDDDDDDD-g###
-------D----------D-####
------D-----------D#####
TT--XXXXXXXXXXXXXXXXXXXX
tt--XXXXXXXXXXXXXXXXXXXX