------------------------
------------------------
------------------------
------------------------
------------------------
------------------------
------------------------
------------------------
------------------------
----------------X-------
--------TT-----XX-------
-------otto-----X-------
-------otto-----X-------
-gX-X--otto--X-X--------
XXXXXXXXXXXXXXXXXXXXX--X
XXXXXXXXXXXXXXXXXXXXX--X