---------------DD-------
---------------DD-------
---------------DD-------
---------------DD-------
---------------DD-------
---------------DD-------
---------------DD-------
------D--------DD-------
---------------DD-------
DDDDDDD---XX---DD----XX-
----D---X-XX---DD----XX-
----D---X-D----------D--
------o-X-D---------*D--
r-----*-X-D*--oooo--D---
XXXXXXXXX--DDDDDDDDD----
XXXXXXXXX---------------