-----------------------D
-----------------------D
------#----------------D
------#----------------D
-----------------------D
---#-------------------D
---#-----------------o-D
---#-----------------o--
------#--------------o--
------#--------------D-X
------#--o-------------X
o----##--o----------*---
#---###--o-------*--D---
-y--###-----g--g-D--D---
XXXXXXXXXXXXXXXXXXXXXX--
XXXXXXXXXXXXXXXXXXXXXX--