-----DD--------------D--
------D--------------D--
------D--------------D--
------D--------------D--
------D--------------D--
------D--------------D--
------D--------------D--
--D---D----------D---D--
DDDo--D--------------DDD
---oD-DDDDDDDDDDDD------
---oD----------D---X----
---DD-o--------D---X----
----X-*----------o-XXooo
y---X-D----r-----*-XX---
XXXXXXXXXXXXXXXXXXXXXXXX
XXXXXXXXXXXXXXXXXXXXXXXX