------------------------
------------------------
------------------------
------------------------
------------------------
----------D-------------
----------------o-------
---------------Xo-------
------TT-------Xo-------
------tt----XXXXXTTXXXXX
--TToott----XXXXXttXXXXX
--ttoott---------tt-----
--ttoott---------tt-----
--ttggtt---------tt-----
XXXXXXXXXXX------tt-----
XXXXXXXXXXX------tt-----