-------------------D-D--
-------------------D-D--
D------------------D-D--
D------------------D-D--
DDD----------------D-D--
--D----------------D-D--
T-D-D--------------D-D--
toD----------------D-D--
to--D--------------D-D--
to---DD---oooooo---D-D--
tDTTD-----TTTTTT---D-D--
t-tt------tttttt-----Do-
t-tt------tttttt-D---D*-
t-tt------tttttt-D------
t-tt------tttttt-DTTXXXX
t-tt------tttttt-XttX---