---------------D--------
---------------D--------
-------------#-D--------
-------------#-D--------
---------------D*-------
----------#----DD-------
----------#----D--------
----------#-------------
-------------#----k----k
-------------#-XXXXXXXXX
-------------#-XXXXXXXXX
------oo----##----------
--#---##---###----------
--#--y--y--###----------
XXXXXXXXXXXXXX----------
XXXXXXXXXXXXXX----------