---------------------U--
------------------------
---------------------D--
-----------------------D
---------------------D--
-----------------------D
----------------D----D--
---------------oD--g--g-
---------------DDDDDDDDD
---------------D--------
---o--------------------
---o----------*----ooo--
---o-------*--D----o-o--
-------k---D--D----ooo--
XXXXXXXXXXXXXXXX--------
XXXXXXXXXXXXXXXX--------