------------------------
------------------------
---#-----------o--------
---#-----G--G-D-D-------
-----DDDDDDDDDDoD-------
#----DDDDDDDDDD-D-------
#-------------DoD-------
#---D---------D-D-------
---#----------DoD-------
---#----------D-D-------
---#----------DoD----o--
--##----------D-D----o--
-###----------Do-----o--
-###----------D---------
XXXX----------XXXXXXXXXX
XXXX----------XXXXXXXXXX