------------------------
------------------------
------------------------
D-----------------------
D--------------------oo-
D--------------X--------
D--------------X--------
D-------------XX--------
D-XXX--XXXXX-XXX-XXX----
X-XXX--XXXXX-XXX-XXX----
X-------------oX---X----
-X------------oXX--X----
-X------------oXX--X----
---------g----oX---X----
-XXXX--XXXXX-XXXXXXX----
-XXXX--XXXXX-XXXXXXX----