------------------------
------------------------
------------------------
------------------------
------------------------
-----------------D------
------------------------
------------------------
-g-----------TT-------oo
###----------tt----DD-DD
---------TToott---------
---------ttoott---------
---------ttoott---------
---------ttggtt---------
---XXXXXXXXXXXXXXX------
---XXXXXXXXXXXXXXX------