------------------------
------------------------
------------------------
------------------------
------------------------
------------------------
------------------------
------------------------
------------------------
--------------------X---
------------TT-----XX--o
-----------otto-----X--o
----D------otto-----X--o
----D-X-X--otto--X-X----
XXXXXXXXXXXXXXXXXXXXXXXX
XXXXXXXXXXXXXXXXXXXXXXXX