-------------------D----
-------------------D----
-------------------D----
-----------DDTT------k-k
---------g-DDtt--TT-DDDD
-------DDD---tt--tt-----
-----TTDD----tt--tt-----
-----tt------tt--tt-----
-g---tt------tt--tt-----
XXTTXXXXXX---tt--tt-----
XXttXXXXXX---tt--tt-----
--tt---------tt--tt-----
--tt---------tt--tt-----
--tt---------tt--tt-----
--tt---------tt--tt-----
--tt---------tt--tt-----