------------------------
------------------------
------------------------
----------------------DD
--------------------g-DD
------------------DDD---
----------------TTDD----
----------------tt------
----------g-g---tt------
-----XXXXXXXXTTXXXXXX---
----XXXXXXXXXttXXXXXX---
-----X-------tt---------
-----X-------tt---------
--X-X--------tt---------
XXXXXX-------tt---------
XXXXXX-------tt---------