-----D------------DDD---
-----D------------D-D---
-----D------------D-D---
-----D------------D-D---
-----D------------D-D---
-----D------------D-D---
-----D*-----------D-D---
---o--------------D-D---
---D-X*-----------D-D---
---D-XX*------k---D-DDDD
-----XXXXXXXXXXXXo------
--*-------------Xo--o---
--D-------------Xo--*---
--D-------------Xo--D---
XXXX------------XXXXXXXX
XXXX------------XXXXXXXX