------------------------
------------------------
------------------------
------------------------
------------------------
---------------------D--
------------------------
------------------------
-----------------TT-----
SS---D-----------tt-----
-----D-------TToott-----
--SSSD-------ttoott-----
---ooD-------ttoott-----
---ooD-------ttggtt-----
XXXXXXXXXXXXXXXXXXXXXXXX
XXXXXXXXXXXXXXXXXXXXXXXX