------------------------
------------------------
------------------------
------------------------
------------------------
------------------------
------------------------
------------------------
------------------------
----------------X-------
--------TT-----XX------T
-------otto-----X------t
D------otto-----X------t
D-X-X--otto--X-X-------t
XXXXXXXXXXXXXXXXXXXXXXXX
XXXXXXXXXXXXXXXXXXXXXXXX