------------------------
------------------------
------------------------
---X--gX-g--------------
XXXXXXXXXX--------------
XXXXXXXXXX------------#-
---------X------------#-
---------X------------#-
------------------------
------------------------
-DD--D-D-DD-------------
-D-D-D-D-D--------oo----
-DD--D-D-DD---#---##---#
-D-D--D---DX--#--y--y--#
-D-D--D--DDXXXXXXXXXXXXX
-----------XXXXXXXXXXXXX