------------------------
------------------------
------------------------
------------------------
--------------------g-X-
------------------DDD-XX
----------------TTDD--XX
----------------tt----XX
----------g-g---tt----XX
-----XXXXXXXXTTXXXXXX-XX
----XXXXXXXXXttXXXXXX-XX
-----X-------tt-------XX
-----X-------tt-------XX
--X-X--------tt-------XX
XXXXXX-------tt-------XX
XXXXXX-------tt-------XX