----D------------D------
----D------------D------
----D------------D------
----D------------D------
----D------------D------
----D------------D------
----D*-----------D------
--o--------------D------
--D-X*-----------D------
--D-XX*------k---D------
----XXXXXXXXXXXXo-------
-*-------------Xo-------
-D-------------Xo-------
-D-------------Xo-D-----
XXX------------XXXXXX---
XXX------------XXXXXX---