--------------------D---
--------------------D---
---------#----------D---
---------#---#-----oD---
-----------###-----oD---
------#--------#--y-----
------#--------#####----
------#-----------------
---------#---------#g-g-
---------#---------#####
---------#--------------
--oo----##--------------
--##---###--------------
-y--y--###--------------
XXXXXXXXXX--------------
XXXXXXXXXX--------------