----------D-------------
----------D-------------
----------D-------------
D-DDTT------k-k---------
D-DDtt--TT-DDDDD--------
D---tt--tt--------------
D---tt--tt--------------
D---tt--tt--------------
D---tt--tt----------g-g-
X---tt--tt------XXXXXXXT
X---tt--tt------XXXXXXXt
----tt--tt-------------t
----tt--tt-------------t
----tt--tt-------------t
----tt--tt-------------t
----tt--tt-------------t