------------------------
------------------------
------------------------
------------------------
------------------------
------------------------
------------------D-----
-----------------YD-----
-----------------DD-DDTT
DDD---------------D---tt
------------g-g-g-D---tt
--------DDDDDDDDDDD---tt
-------D----------D---tt
------D-----------D---tt
TT--XXXXXXXXXXXXXXX---tt
tt--XXXXXXXXXXXXXXX---tt