------------------------
------------------------
-------------------#----
-------------------#----
------------------------
----------------#-------
----------------#-------
----------------#-------
-------------------#----
-------------------#----
-------------------#----
-S-C--------oo----##----
--------#---##---###---D
-----X--#--y--y--###--D-
X-XXXXXXXXXXXXXXXXXXXXXX
X-XXXXXXXXXXXXXXXXXXXXXX