------------------------
------------------------
------------#-----------
------------#-----------
------------------------
---------#--------------
---------#--------o-----
---------#-------Xo-----
------------#----Xo-----
------------#-XXXXXTTXXX
------------#-XXXXXttXXX
-----oo----##------tt---
-#---##---###------tt---
-#--y--y--###------tt---
XXXXXXXXXXXXX------tt---
XXXXXXXXXXXXX------tt---