------------------------
------------------------
------------------------
------------------------
------------------------
------------------------
----------------D-------
---------------YD-DDDD--
---------------DD-------
----------------DD------
----------g-g-g-D-------
------DDDDDDDDDDD-------
-----D----------D-------
----D-----------D-------
--XXXXXXXXXXXXXXXXXXXXXX
XXXXXXXXXXXXXXXXXXXXXXXX