----DDD---------------D-
----D-D---------------D-
----D-D---------------D-
----D-D---------------D-
----D-D---------------D-
----D-D---------------D-
----D-D---------------D-
----D-D----------D----D-
----D-D---------------D-
----D-DDDDDDDDDDDD----DD
DDDD-----------D---X----
------o--------D---X----
------*----------o-X----
------D----r-----*-X----
XXXXXXXXXXXXXXXXXXXXXXXX
XXXXXXXXXXXXXXXXXXXXXXXX