------------------------
------------------------
------------------------
------------------------
------------------------
------------------------
------------------------
------------------------
--o---------------------
--o------------------X##
-------------TT-----XX-#
--!---------otto-----X--
------------otto-----X--
----g-gX-X--otto--X-X---
XXXXXXXXXXXXXXXXXXXXXX--
XXXXXXXXXXXXXXXXXXXXXX--