------------------------
------------------------
-----------------#------
-----------------#------
------------------------
--------------#---------
--------------#--------o
-k------------#-------Xo
XX---------------#----Xo
XX---------------#-XXXXX
-----------------#-XXXXX
----------oo----##------
------#---##---###------
---X--#--y--y--###------
---XXXXXXXXXXXXXXX------
---XXXXXXXXXXXXXXX------