------------------------
------------------------
---------#--------------
---------#--------------
------------------------
------#-----------------
------#-----------------
------#-----------------
---------#--------------
---------#--------------
---------#--------------
--oo----##-------C-S-S-C
--##---###--------------
-y--y--###-------ooo----
XXXXXXXXXXXXXX--XXXXX-XX
XXXXXXXXXXXXXX--XXXXX-XX