------------------------
------------------------
------------------------
-------------------o--o-
------------------------
------------------------
-------------------#----
-----------o-----g##----
-----------D-----###----
-----------D---g####----
---------------#####----
----------*--g######----
-------*--D--#######----
---k---D--D-########----
XXXXXXXXXXXXXXXXXXXXXXXX
XXXXXXXXXXXXXXXXXXXXXXXX