------------------------
------------------------
------------------------
------------------------
------------------------
--------------------X---
--------------------X---
-------------------XX---
-------XXX--XXXXX-XXX---
-----X-XXX--XXXXX-XXX---
----XX-------------oX---
-----XX------------oX---
-----XX------------oX---
--X-X---------g----oX---
XXXXXXXXXX--XXXXX-XXXXXX
XXXXXXXXXX--XXXXX-XXXXXX