------------------------
------------------------
------------------------
------------------------
-----oo-----------------
------------oX----------
------------oX----------
------------XX----------
-XXX----XX--XX----------
-XXX----XX--XX----------
---X---------X---------g
X--X---------X-----DDDDD
X--X---------X----D-----
---X---------X---D------
XXXX---------X-XXXXXXXXX
XXXX---------X-XXXXXXXXX