------------------------
------------------------
------------------------
-G----------------------
-DD---------------------
-DD---------------------
-D----------------------
D--D--------------D-----
--------------------X---
-----------o----D---X---
-----------o--------X---
-----------o------D-X---
-----------o------D-X---
----D------r------D-X-r-
----XXX----D----XXXXXXX-
----XXX---------XXXXXXX-