------------------D-----
------------------D-----
------------------D-----
------------------D-----
------------------D-----
------------------D-----
---o--------------D-----
---o--------------D-----
---o--------------D-----
---DDD---oooooo---D-----
---------TTTTTT---D-----
--*------tttttt---------
--D------tttttt-D-------
--D------tttttt-D--X-X--
XXXX-----tttttt-DTTXXXXX
XXXX-----tttttt-XttXXXXX