------------------------
------------------------
------------------------
------------------------
------------------------
------------------------
------------------QQQQ--
-----oooo---------------
------------------------
--------------------y---
--TT------------QQ?SSQQQ
--TT--------------------
--TT--------------------
--TT--------------------
XXXXXXXXXXXXXXXXXXX--XXX
XXXXXXXXXXXXXXXXXXX--XXX