------D---------D-------
------D---------D-------
-YYY--D---------D-------
-DDD--D---------D-------
---D--D---------D-------
---D--D---------D-------
-D-D--D---------D-------
-o-D--D---------D-------
-o-D--D---------D-------
DDDD--DDDDDDDDDDD-------
------------------------
-----------------------D
----------ooo---oo----D-
-----------y--Y--y---D--
----XXXXXXXXXXXXXXXXXXXX
----XXXXXXXXXXXXXXXXXXXX