------------------------
------------------------
------------------------
------------------------
-g----------------------
DD----------------o-----
D-----------------o-----
---------------o--o-----
---X-----------2X-o--oo-
XX-X------------X-o--TT-
XX-X-----------oX-o--tt-
---X-----------2X-o-----
---X------------X-------
---X-r-----r----X-----g-
--XXXX--XX-XX-XXXX---XX-
--XXXX--XX-XX-XXXX---XX-