-----------------------
-----------------------
-----------------------
-----------------------
-----------------------
-----------------------
-----------------------
-----------------------
-----------------------
----g------------------
----TT-----------------
----TT----------g------
----TT----------TT-----
----TT----------TT--g--
XXXXXXX---XXXXXXXXXXXXX
XXXXXXX---XXXXXXXXXXXXX