-----------------------
-----------------------
-----------------------
SSSSSSSSSSSSSSSSSSSSSSS
-----------------------
-----------------------
-----------------------
-----------------------
-----------------------
-----------------------
-----------------TT----
-----------TT----TT----
-----------TT----TT----
----g-g-g--TT----TT--g-
XXXXXXXXXXXXXXXXXXXXXXX
XXXXXXXXXXXXXXXXXXXXXXX