------------------------
------------------------
------------------------
------------------------
------------------------
------------------------
------------------------
---------oooo-----------
------------------------
------------------------
------TT--------------TT
------TT--------------TT
------TT--------------TT
---y--TT---y------y---TT
XXXXXXXXXXXXXXXXXXXXXXXX
XXXXXXXXXXXXXXXXXXXXXXXX