-----------------------
-----------------------
-----------------------
-----------------------
-----------------------
-----------------------
---SSSSS---------------
-----------------------
-------------TT--------
-------------TT--------
--------2----TT--------
------TT-----TT-----TT-
tt----TT--TT-TT-----TT-
tt----TT--TT-TT---k-TT-
XXXXXXXXXXXXXXXXXXXXXXX
XXXXXXXXXXXXXXXXXXXXXXX