-----------------------
-----------------------
-----------------------
-----------------------
-----------------------
-------------------y---
-------------------##--
-----------------y###--
-----------------####--
----------------#####--
---------------######--
--------------#######--
-------------########--
-y----------#########--
XXXXXXXXXXXXXXXXXXXXXXX
XXXXXXXXXXXXXXXXXXXXXXX