------------------------
------------------------
------------------------
------------------------
------------------------
------------------------
-----------------LSSS---
------------------------
-------------g----------
-------------#----------
----SUS-----##---2-----#
-----------###---------#
----------####---------#
---------#####----kk---#
XXXXXXXXXXXXXXXXXXXXXXXX
XXXXXXXXXXXXXXXXXXXXXXXX