------------------------
------------------------
------------------------
------------------------
------------------------
------------------------
------------USSS--------
------------------------
------------------------
----------E------TT-----
---------TT------TT-----
--g------TT--tt--TT-----
--TT-----TT--tt--TT-----
--TT--g--TT--tt--TT-----
XXXXXXXXXXXXXXXXXXXXXXXX
XXXXXXXXXXXXXXXXXXXXXXXX