------------------------
------------------------
------------------------
-------SSSSSSSSSSSSSSSSS
------------------------
------------------------
----CSS-----------------
------------------TT----
SS--2-------------TT----
---2-2------------TT----
------2---------SCTTSU--
------------TT----TT----
------------TT----TT----
------------TT---kTT---k
---XXXXXXXXXXXXXXXXXXXXX
---XXXXXXXXXXXXXXXXXXXXX