-----------------------
-----------------------
-----------------------
-----------------------
-----------------------
-----------------------
----------------SSQSSS?
-----------------------
-----------------------
------------------K----
--------TT------SSSSSSS
--------TT-------------
--------TT-------------
----k---TT-------------
XXXXXXXXXXXXXXXXXXXXXXX
XXXXXXXXXXXXXXXXXXXXXXX