------------------------
------------------------
------------------------
------------------------
------------------------
------------------------
------------------------
------------------------
------------------------
------------------------
---TT-------------------
---TT-----------------TT
---TT-----------------TT
--gTT--------------gggTT
XXXXXXXXXX---XXXXXXXXXXX
XXXXXXXXXX---XXXXXXXXXXX