-----------------------
-----------------------
-----------------------
-----------------------
-----------------------
-----------------------
-SSCSS------SSSS-------
-----------------------
-----------------------
-----------------------
QQQ--QQQ---------------
-----------------------
-----------------------
--------ggg------------
XXXXXXXXXXXX----XXXXXXX
XXXXXXXXXXXX----XXXXXXX