------------------------
------------------------
------------------------
------------------------
------------------------
------------------------
------------------------
------------------------
o-----------------------
-o---------------o------
o-o--------------o------
-o-o--K----------o------
--D---D----------o------
D---D------------o------
XXXXXXXXXX-------X-----X
XXXXXXXXXX-------X-----X