-D------------D---------
-D------------D---------
-D------------D---------
-D------------D---------
-D------------D---------
-D------------D---------
-D------------D---------
-D------------D---------
-D------------D---------
-D------------D---------
-DDDDDDDDDDDDD---o------
------oo---------o------
-----------------o------
-k--y----y-----------k--
XXXXXXXXXXXXXXXXXXXXXXXX
XXXXXXXXXXXXXXXXXXXXXXXX