------------------------
------------------------
---------------------YYY
---------------------DDD
-----------------------D
-----------------------D
---------------------D-D
------D--------------o-D
-------------ooo-----o-D
DDDDDDD---DD-DDDD-DDDDDD
----D---X---------------
----D---X---------------
------o-X---------------
r-----*-X---------------
XXXXXXXXX---------------
XXXXXXXXX---------------