------------------------
------------------------
------------------------
------------------------
------------------------
------------------------
------o-----------------
-----o-o----------------
----o-o-o---------------
DDDDDDDDDDDD------------
------------------------
--------------------oo--
----TT----------#---##--
----tt-------X--#--y--y-
TT--tt---TT--XXXXXXXXXXX
tt--tt---tt--XXXXXXXXXXX