----------------
----------------
----------------
----------------
----------------
--------o-------
--------#-------
-------##-------
-----o-##-------
-----#-##-------
----##-##-------
---###-##-------
-o-###-##-------
-#-###-##g--g#--
XX-XXX-XXXXXXXXX
XX-XXX-XXXXXXXXX