------------------------
------------------------
------------------g-----
-------X--gX-g--DDDDD---
XXXXXXXXXXXXXX--DDDDD---
XXXXXXXXXXXXXX--D---D---
-------------X--D---D---
-------------X--D---D---
----------------D---D---
----------------D---D---
-D-D-DD--D-D-DD-D---D---
-D-D-D-D-D-D-D--D---D---
-DD--DD--D-D-DD-D---D---
-D-D-D-D--D---D-D---DTT-
-D-D-D-D--D--DDXXXXXXttX
---------------XXXXXXttX