------------------------
------------------------
------------------------
------------------------
------------------------
------------------------
------------------------
------D-----------------
------------------------
DDDDDDD----------o------
----D---X--------o------
----D---X--------o------
------o-X--------o------
r-----*-X--------o------
XXXXXXXXXX-------X-----X
XXXXXXXXXX-------X-----X