------------------------
------------------------
------------------------
------------------------
------------------------
------------------------
------------------------
------------------------
DDDDDDDDD---------------
------------------------
--------------------g-g-
--o--------Y----DDDDDDDD
--o--------Y---D--------
--o-----Dy-D--D---------
--X-----XXXXXXXXXXXXXXXX
--X-----XXXXXXXXXXXXXXXX