-----D------------------
-----D------------------
-----D------------------
----oD------------------
----oD------------------
#--y--------------------
#####-------------------
------------------------
----#g-g--------o-------
----######-----o-o------
--------------o-o-o-----
-------------o-o-o-o----
----------D-----|-------
----------X-k---|----k--
----------XXXXXXXXXXXXXX
----------XXXXXXXXXXXXXX