------------------------
------------------------
------------------------
------------------------
------------------------
------------------------
-------------------o----
------------------Xo----
---oooo-----g-----Xo----
#--####--#####-XXXXXTTXX
#-y#--#-y#-----XXXXXttXX
-##----##-----------tt--
--------------------tt--
--------------------tt--
--------------------tt--
--------------------tt--