------------------------
------------------------
------------------------
-------X--gX-g----------
XXXXXXXXXXXXXX----------
XXXXXXXXXXXXXX----------
-------------X----------
-------------X----------
------------------------
------------------------
-D-D-DD--D-D-DD------TT-
-D-D-D-D-D-D-D------otto
-DD--DD--D-D-DD-----otto
-D-D-D-D--D---DX-X--otto
-D-D-D-D--D--DDXXXXXXXXX
---------------XXXXXXXXX