----------------------D-
----------------------D-
----------------------D-
----------------------D-
----------------------D-
----------------------D-
----------------------D-
----------------------D-
----------------------D-
o---------------------DD
o-----------------------
o------------C-S-S-C----
------------------------
D-gD-g-------ooo--------
XXXXXXXXXX--XXXXX-XXX--T
XXXXXXXXXX--XXXXX-XXXX-t