------------------------
------------------------
------------------------
------------------------
------------------------
------k-----------------
-----SQS--SQS-----------
------------------------
------------------------
------------------------
-----SQS--S?S--------SCS
-----------------------K
------------------------
---k------ggg--------K--
XXXXXXXXXXXXXXXXXXXXXXXX
XXXXXXXXXXXXXXXXXXXXXXXX