------------------------
------------------------
------------------------
------------------------
------------------------
----------oo------------
SSS------%%%%-----------
----------||--o----R----
----------||-%%%--------
----------||--|---------
--%%%-----||--|---------
---|------||-o|---------
---|------||%%%%%-------
---|------||-|||--------
---|------||-|||-----%%%
---|------||-|||------|-