------------------------
------------------------
------------------------
SSSSSSSSSSSSSSSSSSSSSSSS
------------------------
------------------------
------------------------
------------------------
------------------------
------------------------
-----------------------g
----------SS-----------#
---TT-----SS---------g##
-g-TT-----SS---------###
XXXXXXXX--XX--XXXXXXXXXX
XXXXXXXX--XX--XXXXXXXXXX