------------------------
------------------------
------------------------
-------oo---------------
------------g-g---------
r---------%%%%%%%-------
%----------|||||--------
-----------|||||----oo--
-----------|||||--------
-----%%%%%-|||||--------
%%----|||--|||||--------
|-----|||--|||||--------
|--o--|||--|||||--------
|-%%%-|||--|||||--------
|--|--|||--|||||----%%%%
|--|--|||--|||||-----||-