------------------------
------------------------
------------------------
---oo-------------------
----------g-g-----------
------%%%%%%%-----------
-------|||||------------
-------|||||----oo---SSS
-------|||||------------
-%%%%%-|||||------------
--|||--|||||------------
--|||--|||||------------
--|||--|||||------------
%-|||--|||||------------
--|||--|||||----%%%%----
--|||--|||||-----||-----