------------------------
------------------------
------------------------
------------------------
------------------------
------oo----------------
-----%%%%---------------
------||--o----R--------
------||-%%%------------
------||--|-------------
%-----||--|-------------
------||-o|---------%%%%
------||%%%%%--------|||
------||-|||---------|||
------||-|||-----%%%-|||
------||-|||------|--|||