------------------------
------------------------
------------------------
------------------------
------------------------
------------------------
------------------------
------------------------
-------*----------------
-------*----------------
-----SS#CS--------------
-------------------TT---
-----------*-------TT---
-----------*-------TT---
XXXXXXXXXXXXXXXX--XXXXXX
XXXXXXXXXXXXXXXX--XXXXXX