------------------------
------------------------
------------------------
------------------------
------------------------
------------------------
------------------------
------------------------
------------------------
------------------------
------------------------
----#-------------------
----#-------------------
----#----ggg--k----ggg--
XX--XXXXXXXXXXXXXXXXXXXX
XX--XXXXXXXXXXXXXXXXXXXX