------------------------
------------------------
------------------------
SSSSSSSSSSS-----SSSSSSSS
----------------SSSSSSSS
----------------SSSSSSSS
----------------SSSSSSSS
----------------S-------
----------------S-------
------------------oooooo
-----------------USSSSSS
----------#-------------
---------##-SSS---------
--------###-------------
--XXXXXXXXX-----XXXXXXXX
--XXXXXXXXX-----XXXXXXXX