------------------------
------------------------
------------------------
------------------------
------------------------
----X-------------------
----X-----o-------------
---XX----Xo-------------
X-XXX----Xo-------------
X-XXX-XXXXXTTXXXXXX-----
---oX-XXXXXttXXXXXX-----
---oX------tt---------21
---oX------tt-----------
---oX------tt---------g-
X-XXX------tt-------XXXX
X-XXX------tt-------XXXX