----------------------------------------------------------------------------------------------------------------------------------------------------------------------------------------------------------
----------------------------------------------------------------------------------------------------------------------------------------------------------------------------------------------------------
----------------------------------------------------------------------------------------------------------------------------------------------------------------------------------------------------------
----------------------------------------------------------------------------------------------------------------------------------------------------------------------------------------------------------
----------------------------------------------------------------------------------------------------------------------------------------------------------------------------------------------------------
-------------------------------------------------------------------------------------------------------------------------------!--------------------------------------------------------------------------
-----------SSS------SSSS----------------------------SSS-----S---------------------------------------------SSS---------------------------------------------#---------------------------------------SS------
-----------------------------------------------------------------------------------------------------------SS--------------------------------------------###-----------------------------------SSSSS------
--------------------------------------------------------------------------------------------------------------------------------------------------------####-------##-------------------------------------
--------###----------------------------------------------------------------------------------------------------------------------------!---------------######-----##--###---------------------------------
-------####----S--------------tt----------------------------------------S!SS----S---------------------------------------------------------------------######-----###---###--------------------------------
-------####-------------------tt--------------------------------------------------------------------------------------------------------------------########-----####--###--------------------------------
------######------------------tt----------------------------------------------------------------------------------------------------------------tt-#########-----####-#####-------------------------------
------######-------------#g---tt------------------------------------gg--------g-g-------------g------------------------------g------------g-g-#-tt-####-####----############-----g-g----------------------
----XXXXXXXXXXXXXXXXXXXXXXXXXXXXXXXXXXXXXXXXXXXXXXXXXXXXXXX---XXXXXXXXXXXXXXXXXXXXXXXXXXXXXXXXXXXXXXXXXX---XXXXXXXXXXX---XXXXXXXXXXXXXXXXXXXXXXXXXXXXXXXXXXX---XXXXXXXXXXXXXXXXXXXXXXXXXXXXXXX----XXXXXXXX
----XXXXXXXXXXXXXXXXXXXXXXXXXXXXXXXXXXXXXXXXXXXXXXXXXXXXXXX---XXXXXXXXXXXXXXXXXXXXXXXXXXXXXXXXXXXXXXXXXXX--XXXXXXXXXXX---XXXXXXXXXXXXXXXXXXXXXXXXXXXXXXXXXXXXXXXXXXXXXXXXXXXXXXXXXXXXXXXXXXXXX----XXXXXXXX