-----------U----------D-
----------------------D-
-----------D----------D-
-------------D--------D-
-----------D----------D-
-------------D--------D-
-----DD----D----------D-
----YDD--g--g---------D-
----DDDDDDDDDD--------D-
-----D--------D-------D-
-g-g-D---------D------DD
DDDDDD---ooo----D-------
-----D---o-o-----D------
-----D---ooo------D---k-
XXXXXX-------------XXXXX
XXXXXX-------------XXXXX