-----D--------------D---
-----D--------------D---
---#-D--------------D---
---#-D--------------D---
-----D--------------D---
#----D--------------D---
#----D------o-------D---
#----D-----o-o------D---
---#-D----o-o-o-----D---
---#-DDDDDDDDDDDDD--DDDD
---#--------------------
--##--------------------
-###------TT------------
-###------tt------------
XXXX--TT--tt---TT----TT-
XXXXX-tt--tt---tt--X-tt-