------------------------
------------------------
------------------------
------------------------
------------------------
------------------------
------------------------
------------------------
-------------D----------
--------SSS@SSSS---D----
---------------S---D----
----------------SSSD----
----D---oo-------ooD----
----D---oo--g----ooD---D
XXXXXXXXXXXXXXXXXXXXXXXX
XXXXXXXXXXXXXXXXXXXXXXXX