----------D---------D---
----------D---------D---
-----YYY--D---------D---
-----DDD--D---------D---
-------D--D---------D---
-------D--D---------D---
-----D-D--D---------D---
-----o-D--D---------D---
-----o-D--D---------D---
D-DDDDDD--DDDDDDDDDDD---
------------------------
------------------------
--------------ooo---oo-o
---------------y--Y--y-#
--------XXXXXXXXXXXXXXXX
--------XXXXXXXXXXXXXXXX