-----------------------D
-----------------------D
-------------------YYY-D
-------------------DDD-D
---------------------D-D
---------------------D-D
------D------------D-D-D
-----YD------------o-D--
-----DD----ooo-----o-D-X
------D-DD-DDDD-DDDDDD-X
g-g-g-D----------------X
DDDDDDD-----------------
------D-----------------
------D-----------------
XXXXXXX-----------------
XXXXXXX-----------------