--D---------------------
--D---------------------
--D---------------------
--D---------------------
--D---------------------
--D---------------------
--D---------------------
--D---------------------
--D---------------------
DDD--------------------o
-----------------------#
----------------------##
--oo--D-----*-----D---##
Y--y--D-----D-----D-#-##
XXXXXXXXXXXXXXXXXXXXX-XX
XXXXXXXXXXXXXXXXXXXXX-XX