----------D-------------
----------D-------------
----------D-------------
----------D-------------
----------D-------------
----------D-------------
----------D-------------
----------D-------------
----------D-------------
----------D-------------
DDDDDDDDDD---------g-g-g
--oo-----------DDDDDDDDD
--------------D---------
y----y-------D----------
XXXXXXXXXXXXXXXXXXXXXXXX
XXXXXXXXXXXXXXXXXXXXXXXX