----------D-------------
----------D-------------
----------D-------------
----------D-------------
----------D-------------
----------D-------------
----------D-------------
----------D-------------
----------D------o------
----------D-----o-o-----
DDDDDDDDDD-----o-o-o----
--oo-------K--o-o-o-o--K
-----------D---D---D---D
y----y-------D---D---D--
XXXXXXXXXXXXXXXXXXXXXXXX
XXXXXXXXXXXXXXXXXXXXXXXX