--D---D------------D----
--D---D------------D----
--D---D------------D----
--D---D------------D----
--D---D------------D----
--D---D------------D----
--D---D------------D----
--D---D------------D----
--D---D------------D----
DDD---D------------D----
------DDDDDDDDDDDDD----#
-----------oo---------##
--oo----------------o-##
Y--y--k--y----y-----#-##
XXXXXXXXXXXXXXXXXXXXX-XX
XXXXXXXXXXXXXXXXXXXXX-XX