------------------------
------------------------
------------------------
------------------------
------------------------
------------------------
------------------------
-----------------------Y
--D--------------------D
@SSSS---D---------------
----S---D---------g-g-g-
-----SSSD-----DDDDDDDDDD
------ooD----D----------
-g----ooD---D-----------
XXXXXXXXXXXXXXXXXXXXXXXX
XXXXXXXXXXXXXXXXXXXXXXXX