------------------------
------------------------
------------------------
------------------------
------------------------
------------------------
------------------------
------------------------
------------------------
----------------------o-
----------------------o-
-2122222222X----------o-
-----ooooooX----------o-
-g--gooooooX----------o-
XXXXXXXXXXXXXXX-------X-
XXXXXXXXXXXXXXX-------X-