-----------------------
-----------------------
-----------------------
-----------------------
-----------------------
-----------------------
-SUS-------------------
-----------------------
-----------------------
-----------------------
#####------------------
#----------------------
#---------------------*
#--------------ggg----*
XXX----XXXXXXXXXXXXXXXX
XXX----XXXXXXXXXXXXXXXX