-----------------------
-----------------------
-----------------------
---oo------------------
----------g-g----------
------%%%%%%%----------
-------|||||-----------
-------|||||----oo---SS
-------|||||-----------
-%%%%%-|||||-----------
--|||--|||||-----------
--|||--|||||-----------
--|||--|||||-----------
%-|||--|||||-----------
--|||--|||||----%%%%---
--|||--|||||-----||----