-----------------------
-----------------------
-----------------------
-----------------------
-----------------------
-------------oo--------
-----------------------
-----------------------
-----------------------
--o--------------------
--------TT-------------
--------TT-------------
--------TT---------tt--
--------TT---ggg---tt-k
XXXXXXXXXXXXXXXXXXXXXXX
XXXXXXXXXXXXXXXXXXXXXXX