-----------------------
-----------------------
-----------------------
-----------------------
-----------------------
------k----------------
-----SQS--SQS----------
-----------------------
-----------------------
-----------------------
-----SQS--S?S--------SC
-----------------------
-----------------------
---k------ggg--------K-
XXXXXXXXXXXXXXXXXXXXXXX
XXXXXXXXXXXXXXXXXXXXXXX