-----------------------
-----------------------
-----------------------
-----------------------
-----------------------
o----------------------
----------------R-----o
------------r----------
------%%%%%%%%---------
-------||||||----------
-------||||||-----%%%%-
-------||||||------||--
%%%%---||||||------||--
-||----||||||--ooo-||--
-||----||||||--%%%-||--
-||----||||||---|--||--