-----------------------
-----------------------
-----------------------
-----------------------
-----------------------
-----------------------
--------------------SSS
-----------------------
--------------SSS------
-----------------------
-------r-r-------------
---%%%%%%%%%%%%--------
----||||||||||---------
----||||||||||---------
%%%-||||||||||---------
-|--||||||||||---------