-----------------------
-----------------------
-----------------------
-----------------------
-----------------------
-----------------------
--1--------------------
---------------oooo----
-----------------------
-----------------------
QQQQ-------------------
-------------#---------
-------------#---------
-yy----------#---------
XXXXXXXXXXXXXXXXXXXXXXX
XXXXXXXXXXXXXXXXXXXXXXX