------------------------
------------------------
------------------------
------------------------
------------------------
o-----------------------
----------------R-----oo
------------r-----------
------%%%%%%%%----------
-------||||||-----------
-------||||||-----%%%%--
-------||||||------||---
%%%%---||||||------||---
-||----||||||--ooo-||---
-||----||||||--%%%-||---
-||----||||||---|--||---