------------------------
------------------------
------------------------
------------------------
------------------------
------------------------
------------------------
------------------------
------------------------
%%%------oooo-----------
||--------------%%%%%%--
||---------------||||---
||---------------||||---
||---------------||||---
||%%%%%%%%%-%%%%-||||-%%
||-|||||||---||--||||--|