------------------------
------------------------
------------------------
------------------------
------------------------
------------------------
----------------------SS
------------------------
---*--------------------
---*-------------------K
-SS#CS---------------SSS
---------------TT-------
-------*-------TT-------
-------*-------TT-------
XXXXXXXXXXXX--XXXXXXXXXX
XXXXXXXXXXXX--XXXXXXXXXX