-----------------------
-----------------------
-----------------------
-----------------------
-----------------------
-----------------------
-----------------------
---y-------------------
-#SS--o----------------
##---------------------
##--SC-----------------
##---------------------
##---SSS---------------
##--------------------#
XX------XXXXXXXXX---XXX
XX------XXXXXXXXX---XXX