-----------------------
-----------------------
-----------------------
-----------------------
-----------------------
-----------------------
-----------------------
-----------------------
-----------------------
%%%------oooo----------
||--------------%%%%%%-
||---------------||||--
||---------------||||--
||---------------||||--
||%%%%%%%%%-%%%%-||||-%
||-|||||||---||--||||--