------------------------
------------------------
------------------------
------------------------
------------------------
------------------------
------------------------
------------------------
------------------------
------------------------
------------------------
---#--------------------
---#-------------------#
---#----y--y----------##
XXXX--XXXXXXXXXXXXXXXXXX
XXXX--XXXXXXXXXXXXXXXXXX