-----------------------
-----------------------
-----------------------
-----------------------
------------oo---------
-----------------------
--------------%%%%-----
-------SSS-----||------
SS-oo----------||------
---------------||------
---SS----------||------
---------------||------
---------------||------
---------------||------
---------------||-XXXXX
---------------||-XXXXX