-----------------------
-----------------------
-----------------------
-----------------------
-----------------------
-----------------------
------------------!----
-----------------------
-----------------------
-----------------------
------------!---S@S!S--
-----------------------
-----------------------
-----------------g-----
XXXXXXXXXXXXXXXXXXXXXXX
XXXXXXXXXXXXXXXXXXXXXXX