-----------------------
-----------------------
-----------------------
-------------------oo--
-----------------------
---------ooor---------%
--------%%%%%----------
---------|||-----------
---------|||-----------
---------|||-----%%%%%-
------%%%%%%%%----|||--
-------||||||-----|||--
-------||||||--o--|||--
%%%%---||||||-%%%-|||--
-||----||||||--|--|||--
-||----||||||--|--|||--