-----------------------
-----------------------
-----------------------
SSSSSSS-----SSSSSSSSSSS
------------SSSSSSSSSSS
------------SSSSSSSSSSS
------------SSSSSSSSSSS
------------S----------
------------S----------
--------------ooooooooo
-------------USSSSSSSSS
------#----------------
-----##-SSS------------
----###-------------kk-
XXXXXXX-----XXXXXXXXXXX
XXXXXXX-----XXXXXXXXXXX