-----------------------
-----------------------
-----------------------
SSSSSSSSSSSSSSSSS------
SSSSSSSS---------------
SSSCSSSS---------------
SSSSSSSS--QQ-----------
-----------------------
-------------------SSS-
---ggg-----------------
SSSSSSSS--QQ--QQQ------
SSSSSSSS---------------
SSSSSSSS---------------
SSSSSSSS---------------
XXXXXXXXXXXXXXXXX------
XXXXXXXXXXXXXXXXX------