-----------------------
-----------------------
-----------------------
-----------------------
-----------------------
-----------------------
-----------------------
-----------------------
-#---------------------
##--oo------o----o-----
##---------------------
##---------------------
##---------------------
##--k------------------
XXXXXXXXXXX---XX---XXXX
XXXXXXXXXXX---XX---XXXX