-----------------------
-----------------------
-----------------------
-----------------------
-----------------------
------------------ooor-
-----------------%%%%%-
------------------|||--
------------------|||--
------------------|||--
---------------%%%%%%%%
----------------||||||-
----------------||||||-
---------%%%%---||||||-
XXXXXXX---||----||||||-
XXXXXXX---||----||||||-