-----------------------
-----------------------
-----------------------
-----------------------
-----------------------
-----------------------
-----------------------
-----------------------
-------*---------------
-------*---------------
-----SS#CS-------------
-------------------TT--
-----------*-------TT--
-----------*-------TT--
XXXXXXXXXXXXXXXX--XXXXX
XXXXXXXXXXXXXXXX--XXXXX