-----------------------
-----------------------
-----------------------
-----------------------
-----------------------
-----------------------
-----------------------
-----------------------
-----------------------
--oo-------------------
-----------------------
-----------------------
-----------------------
------------k------kkk-
X----XXXXXXXXXXXXXXXXXX
X----XXXXXXXXXXXXXXXXXX