-----------------------
-----------------------
-----------------------
-----------------------
-----------------------
-----------------------
-----USS---------------
-----------------------
-----------------------
-----------------------
#---#-------------TT---
#---#-------------TT---
#---##------------TT---
#---##--gg----k---TT---
X---XXXXXXXXXXXXXXXXXXX
X---XXXXXXXXXXXXXXXXXXX