-----------------------
-----------------------
-----------------------
-----------------------
-----------------------
---k-------------------
--SSSSSSSSS------------
-----------------------
-----------------------
---------------------SS
-----------------------
-----------------------
--------------TT--TT---
--------------TT--TT---
XXXXXX------XXXXXXXXXXX
XXXXXX------XXXXXXXXXXX