------------------------
------------------------
------------------------
------------------------
------------------------
------------------------
-USS------------------SS
------------------------
------------------------
------------------------
#-------------TT------SS
#-------------TT--------
##------------TT--------
##--gg----k---TT--------
XXXXXXXXXXXXXXXXXXXXXXXX
XXXXXXXXXXXXXXXXXXXXXXXX