-----------------------
-----------------------
-----------------------
-----------------------
-----------------------
-----------------------
------------------SCS--
-----------------------
-----------------------
-----------------------
-----SSS------TT---2---
--------------TT-------
--------------TT-------
-M------------TT----k--
XXXXXXXXXXXXXXXXXXXXXXX
XXXXXXXXXXXXXXXXXXXXXXX