-----------------------
-----------------------
-----------------------
-----------------------
-----------------------
-----------------------
-------USS-------------
-----------------------
-----------------------
-----------------------
-------------------QQQQ
----K---*--------------
--------*-------*------
--------B-------*------
XXXXXXXXXXXXXXXXXXXXXXX
XXXXXXXXXXXXXXXXXXXXXXX