-----------------------
-----------------------
-----------------------
-----------------------
-----------------------
-----g-----------------
-----SSSSS-----SSSSS---
-----------------------
TT---------------------
TT---------------------
XX------------------2--
------------------TT---
-----TT-----tt----TT--T
-----TT-----tt----TT--T
XXXXXXXXXXXXXXXXXXXXXXX
XXXXXXXXXXXXXXXXXXXXXXX