-----------------------
-----------------------
-----------------------
-----------------------
-----------------------
-----------------------
------------------QQQQQ
-----------------------
-----------------------
--------------------k--
-----------TT-----?QQQQ
-----------TT----------
#----------TT----------
#---gg-----TT----------
XXXXXXXXXXXXXXXXXXXXXXX
XXXXXXXXXXXXXXXXXXXXXXX