------------------------
------------------------
------------------------
SSSSSSSSSSSSSSSSSSSSSSSS
------------------------
------------------------
------------------------
------------------------
------------------------
-----------------C------
QQQ--------#-#----------
---------#-#-#-#---#----
-----g-#-#-#-#-#---#-#--
----g#-#-#-#-#-#-E-#-#--
XXXXXXXXXXXXXXXXXXXXXXXX
XXXXXXXXXXXXXXXXXXXXXXXX