-----------------------
-----------------------
-----------------------
-----------------------
-----------------------
-----------------------
-----------------------
--TT-------------------
--TT-------------------
--XX-------------------
----------------TT---SU
-------------K--TT-----
-----TTTT-------TT-----
-----TTTT-------TT-----
XXXXXXXXXXXXXXXXXXXXXXX
XXXXXXXXXXXXXXXXXXXXXXX