-----------------------
-----------------------
-----------------------
-----------------------
-----------------------
-----------------------
-----------------##----
----------------###----
---------------####----
--------------#####----
S------------######----
------------#######----
--------tt-########----
---gg---tt#########----
XXXXXXXXXXXXXXXXXXXXXXX
XXXXXXXXXXXXXXXXXXXXXXX