-----------------------
-----------------------
-----------------------
-----------------------
-----------------------
-----------------------
-------------US--------
-----------------------
-----------------------
-----------------------
------------####--SSC--
-------y-#####---------
----y-######-----------
---#######-------------
XXXXXXXX------XX--XXXXX
XXXXXXXX------XX--XXXXX