-----------------------
-----------------------
-----------------------
-----------------------
---------------K-------
-----------------------
---------------##------
--------------###------
-------------####------
------------#####------
----------TT#####------
---------#TT#####------
--------##TT#####------
-------###TT#####------
XXXXXXXXXXXXXXXXXXXXXXX
XXXXXXXXXXXXXXXXXXXXXXX