------------------------
------------------------
------------------------
------------------------
------------------------
------------------------
------------------------
------------------------
-------------#----------
------------##--oo------
-----------###----------
----------####----------
---------#####----------
------gg######--k-------
XXXXXXXXXXXXXXXXXXXXXXX-
XXXXXXXXXXXXXXXXXXXXXXX-