-----------------------
-----------------------
-----------------------
--------oo-------------
-?-----%%%%------------
--------||-------------
--------||-------------
---r----||--SSS---o---o
%%%%%---||-------%%%-%%
||||----||--------|---|
||||ooo-||--------|---|
||||--r-||--------|---|
%%%%%%%%||--------|---|
|||||||-||--------|---|
|||||||-||-------%%%%%%
|||||||-||--------|||||