------------------------
------------------------
------------------------
------------------------
------------------------
--------------k---------
--------------##--------
-------------###--------
---#--------####--------
--##-------#####--------
-###------######--------
####-----#######--------
####----########--------
####---#########--------
XXXXXXXXXXXXXXXXXXXXXXXX
XXXXXXXXXXXXXXXXXXXXXXXX