-----------------------
-----------------------
-----------------------
-----------------------
-----------------------
-----------------------
S---------------------Q
-----------------------
-----------------------
-----------------------
---#-----------TT-----?
---#-----------TT------
---##----------TT------
---##---gg-----TT------
XXXXXXXXXXXXXXXXXXXXXXX
XXXXXXXXXXXXXXXXXXXXXXX