-----------------------
-----------------------
-----------------------
-----------------------
-----------------------
-----------------------
-----------------------
-----------------------
-----------------------
-----------------------
SS---------TT----------
-K---TT----TT----------
-----TT----TT----------
-----TT---gTT----------
XXXXXXXXXXXXXXXXXX---XX
XXXXXXXXXXXXXXXXXX---XX