------------------------
------------------------
------------------------
SSSSSSSSSSSSSSSSSSSSSSSS
------------------------
------------------------
------------------------
------------------------
------------------------
------------------------
-TT---------------------
-TT-----------SS--------
-TT----TT-----SS--------
-TT--g-TT-----SS--------
XXXXXXXXXXXX--XX--XXXXXX
XXXXXXXXXXXX--XX--XXXXXX