-----------------------
-----------------------
-----------------------
-----------------------
-----------------------
-----------------------
-----------------------
-----------------------
-----TT----------------
-----TT----------------
2----TT-------------tt-
-----TT-----TT------tt-
--TT-TT-----TT------tt-
--TT-TT---k-TT------tt-
XXXXXXXXXXXXXXXXXXXXXXX
XXXXXXXXXXXXXXXXXXXXXXX