-----------------------
-----------------------
-----------------------
-----------------------
-----------------------
-----------------------
-------------##--------
-------------##--------
-----------####--------
---SSS-----####--------
---------######--------
---------######--------
---------######--------
-----r---######--------
XXXXXXXXXXXXXXXXXXXXXXX
XXXXXXXXXXXXXXXXXXXXXXX