------------------------
------------------------
------------------------
------------------------
------------------------
------------------------
------------------------
---o--------------------
---2X-------------------
----X-------------------
---oX-----------------o-
---2X-----------------o-
----X-D-----*-----D---o-
----X-D-----D-----D-----
X-XXXXXXXXXXXXXXXXXXXXXX
X-XXXXXXXXXXXXXXXXXXXXXX