-------------D----------
-------------D----------
-------------D----------
-------------D----------
-------------D----------
-------------D----------
-------------D------o---
---------D---D-----o-o--
-------------D----o-o-o-
DDDDDDDDDD---DDDDDDDDDDD
-------D---X------------
-------D---X------------
---------o-X------TT----
---r-----*-X------tt----
XXXXXXXXXXXX--TT--tt---T
XXXXXXXXXXXXX-tt--tt---t