------------------------
------------------------
-----YYY----------------
-----DDD----------------
-------D----------------
-------D----------------
-----D-D----------------
-----o-D-D----y---y---Y-
-----o-D-DDTTDDDTTDDTTD-
D-DDDDDD---tt---tt--tt--
-----------tt---tt--tt--
-----------tt---tt--tt--
-----------tt---tt--tt--
-----------tt---tt--tt--
-----------tt---tt--tt-X
-----------tt---tt--tt-X