------------------------
------------------------
------------------------
------------------------
------D---------o-*D----
------D---------D--D----
------D------------D----
--D---D*----o------D----
------D-----D------D----
DDD---D---o-------*D---o
D---X-D---D--------D---#
D---X-D*------o----D--##
--o-X-D-------D----D--##
--*-X-------r------D#-##
XXXXXX---X--X--X---XX-XX
XXXXXX---X--X--X---XX-XX