------------------------
-------------o----------
-------------o----------
-------------o----------
-------------o----------
------------*D*---------
-------------*----------
------------*D*---------
-------TT-TTDDDTT-TT----
-----X-DDDDDD--DDDDD----
----XX------------------
-----X-----------------#
-----X-----------------#
--X-X----------------#-#
XXXXXX---------------X-X
XXXXXX---------------X-X