------------------------
------------------------
---#--------------------
---#--------------------
------------------------
#-----------------------
#-----------------------
#-----------------------
---#--------------------
---#--------------------
---#-----------------o--
--##-----------------o--
-###-D-----*-----D---o--
-###-D-----D-----D------
XXXXXXXXXXXXXXXXXXXXXXXX
XXXXXXXXXXXXXXXXXXXXXXXX