---D---------D----------
---D---------D----------
---D---------D----------
---D---------D---------o
---D---------D----------
---D---------D----------
---D---------D---------#
---D---------D-------g##
---D---------D-------###
---DDDDDDDDDDD-----g####
X------------------#####
X----------------g######
X------ooo---oo--#######
X-------y--Y--y-########
XXXXXXXXXXXXXXXXXXXXXXXX
XXXXXXXXXXXXXXXXXXXXXXXX