-----U------------------
------------------------
-----D------------------
-------D----------------
-----D------------------
-------D----------------
-----D------------------
--r------r--------------
%%%%%%%%%%%%%%----------
%%%%%%%%%%%%%%----------
------||------------TToo
------||------------ttoo
------||------------ttoo
------||------------ttgg
------||------XXXXXXXXXX
------||------XXXXXXXXXX