---------------D--------
---------------D--------
---------------D--------
---------------D--------
---------------D--------
---------------D--------
-------------o-D--------
-------------o-D--------
-------------o-D--------
-------------D-D--------
-o-------------DDDDDDDDD
-o----------*-------oo--
-o-------*--D-----------
----g--g-D--D--k--y----y
XXXXXXXXXXXXXXXXXXXXXXXX
XXXXXXXXXXXXXXXXXXXXXXXX