------------------------
------------------------
------------------------
------------------------
------------------------
------------------------
------------------D-----
-----------------YD-----
-----------------DD-----
------------------D-----
------------g-g-g-D-----
S-C-----DDDDDDDDDDD--212
-------D----------D-----
------D-----------D--g--
-XXXXXXXXXXXXXXXXXXXXXXX
-XXXXXXXXXXXXXXXXXXXXXXX