------------------------
------------------------
------------------------
------------------------
------------------------
------------------------
------------------------
------------------------
------------------------
----o-------------------
----o-------o-----------
----o-------o----------*
------------o-------*--D
D--gD-gD-g------k---D--D
XXXXXXXXXXXXXXXXXXXXXXXX
XXXXXXXXXXXXXXXXXXXXXXXX