------------------------
------------------------
------------------------
------------------------
------------------------
-------------D----------
------------------------
------------------------
---------TT----------D--
---------tt-----SSS@SSSS
-----TToott------------S
-----ttoott-------------
-----ttoott-----oo------
-----ttggtt-----oo--g---
XXXXXXXXXXXXXXXXXXXXXXXX
XXXXXXXXXXXXXXXXXXXXXXXX