------------------------
------------------------
------------------------
------------------------
------------------------
--------------D---------
------------------------
------------------------
----------TT------------
----------tt------------
------TToott-----o------
------ttoott-----o------
------ttoott-----o------
------ttggtt--------g--g
XXXXXXXXXXXXXXXXXXXXXXXX
XXXXXXXXXXXXXXXXXXXXXXXX