------------------------
------------------L-----
------------------------
-----------------K------
--------------%%%%%-----
----X---------%%%%%-----
X--XX-----------||------
X---X---k---k---||------
X---X-%%%%%%%%%%%%%-----
XX--X-%%%%%%%%%%%%%-----
----X-------||----------
----X-------||----------
XXXXX-------||----------
XXXXX-------||----------
XXXXX-------||------X---
XXXXX-------||------X---