------------------------
------------------------
------------------------
------------------------
------------------------
------------------------
-----------------o------
--o--------------o------
--D--------------o------
--D--------------DDD---o
-----o-----------------T
-*---o----------*------t
-D---o-------*--D------t
-D------g--g-D--D------t
XXXXXXXXXXXXXXXXXX-----t
XXXXXXXXXXXXXXXXXX-----t