D-----------------------
D-----------------------
D-----------------------
D-----------------------
D-----------------------
D----------------oo-----
D-----------------------
D--------------o--------
D--------------D-DD--oo-
D--------------D-D*-----
---o-------------D*-----
---o----------*--D----g-
---o-------*--D--D---DD-
-------k---D--D--D*-----
XXXXXXXXXXXXXXXX-D------
XXXXXXXXXXXXXXXX-D------