------------------------
------------------------
------------------------
------------------------
------------------------
------------------------
-------------o----------
-------------o----------
-------------o----------
-------------D----------
-o--------------o-------
-o----------*---o-------
-o-------*--D---o-------
----g--g-D--D-------k---
XXXXXXXXXXXXXXXXXXXXXXXX
XXXXXXXXXXXXXXXXXXXXXXXX