------------------------
------------------------
------------------------
------------------------
------------------------
------------------------
------------------------
--------------o---------
--------------D-X-------
--------------D-X-------
--o-------------X-------
--o----------*--X-------
--o-------*--D--X-------
------k---D--D--X-r-----
XXXXXXXXXXXXXXXXXXX--XX-
XXXXXXXXXXXXXXXXXXX--XX-