---------D--------------
---------D--------------
---------D--------------
---------D--------------
---------D--------------
---------D--------------
---------D--------------
-----D---D--------------
---------DDDDDDDDDDDDDD-
DDDDDD---------------D--
---D---X-------------*--
---D---X----------------
-----o-XXoooooooooooo*X-
-----*-XX---y--y--y---X#
XXXXXXXXXXXXXXXXXXXXXXXX
XXXXXXXXXXXXXXXXXXXXXXXX