------------------------
------------------------
------------------------
------------------------
------------------------
------------------------
--------o---------------
--------o---------------
--------o------o--------
--------D-----o-o-------
-------------o-o-o------
-------*----o-o-o-o-----
----*--D-D-----|-------D
--g-D--D-X-k---|----k--X
XXXXXXXXXXXXXXXXXXXXXXXX
XXXXXXXXXXXXXXXXXXXXXXXX