------------------------
------------------------
------------------------
------------------------
-----------------------o
----------------------o-
--------------D-------#-
-------------YD------##-
-------------DD------##-
--------------D---o--##-
--------g-g-g-D---#--##-
----DDDDDDDDDDD--##--##-
---D----------D--##--##-
--D-----------D#-##--##-
XXXXXXXXXXXXXXXX-XX--XXX
XXXXXXXXXXXXXXXX-XX--XXX