------------------------
------------------------
------------------------
------------------------
------------------------
-------------D----------
------------------------
------------------------
---------TT-------ooo---
---------tt----DD-DDDD-D
-----TToott-------------
-----ttoott-------------
-----ttoott-------------
-----ttggtt-------------
XXXXXXXXXXXXXX----------
XXXXXXXXXXXXXX----------