-----------D------------
-----------D------------
-----------D------------
-----------D------------
-----------D------------
-----------D------------
-----------D------------
-----------D------------
-----------D------o-----
-----------D-----o-o----
DDDDDDDDDDD-----o-o-o---
---oo-------K--o-o-o-o--
------------D---D---D---
-y----y-------D---D---D-
XXXXXXXXXXXXXXXXXXXXXXXX
XXXXXXXXXXXXXXXXXXXXXXXX