------------------------
------------------------
------------------------
------------------------
------------------------
------------------------
------------------------
-----------------------#
-----------------------#
D---------o---------o--#
----------o---------#--#
----------o--------##--#
----------o--------##--#
----------o------#-##--#
--X-------X-----XX-XX--X
--X-------X-----XX-XX--X