-------------D----------
-------------D----------
-------------D----------
-------------D----------
-------------D----------
-------------D----------
-------------D----------
-------------D----------
-------------D----------
-------------D----------
-------------DDDDDDDDDDD
------------------oo----
----*-----D-------------
----D-----D--k--y----y--
XXXXXXXXXXXXXXXXXXXXXXXX
XXXXXXXXXXXXXXXXXXXXXXXX