-------------------D----
-------------------D----
-----------------#-D----
-g---------------#-D----
XX-----------------D*---
XX------------#----DD---
-X------------#----D----
-X------------#---------
-----------------#----k-
-----------------#-XXXXX
-DD--------------#-XXXXX
-D--------oo----##------
-DD---#---##---###------
--DX--#--y--y--###------
-DDXXXXXXXXXXXXXXX------
---XXXXXXXXXXXXXXX------