------------------------
------------------------
------------------------
------------------------
------------------------
------------------------
------------------------
------------------------
--------------------TT--
--------------------tt--
----------------TToott--
----------------ttoott--
--*-----D-------ttoott--
--D-----D-------ttggtt--
XXXXXXXXXXXXXXXXXXXXXXXX
XXXXXXXXXXXXXXXXXXXXXXXX