-----------------D------
-----------------D------
-----------------D------
-----------------D------
-----------------D------
-----------------D------
-----------------D------
-----------------D------
-------o---------DDDDDDD
------o-o---------------
-----o-o-o--------------
----o-o-o-o-------------
-D-----|-------D--------
-X-k---|----k--X---XyX-X
XXXXXXXXXXXXXXXXX--XXX-X
XXXXXXXXXXXXXXXXX--XXX-X