----------D------------D
----------D------------D
----------D------------D
----------D------------D
----------D------------D
----------D------------D
----------D------------D
------D---D------------D
----------D------------D
DDDDDDD---D----oo-----oD
----D---X-D-----------*D
----D---X-Do---TT-------
------o-X-D*---tt--oo---
r-----*-X------tt-------
XXXXXXXXXXXXX--tt--TT-XX
XXXXXXXXXX-----tt--tt---