------------------------
------------------------
------------------------
------------------------
------------------------
------------------------
--------o---------------
--------o--------------o
--------o--------------D
--------D--------------D
-----------o------------
-------*---o----------*-
----*--D---o-------*--D-
--g-D--D-------k---D--D-
XXXXXXXXXXXXXXXXXXXXXXXX
XXXXXXXXXXXXXXXXXXXXXXXX