------------------------
------------------------
---#--------------------
---#--------------------
---------oo-------------
#---------------oX------
#---------------oX------
#---------------XX------
---#-XXX----XX--XX------
---#-XXX----XX--XX------
---#---X---------X------
--##X--X---------X-----D
-###X--X---------X----D-
-###---X---------X---D--
XXXXXXXX---------X-XXXXX
XXXXXXXX---------X-XXXXX