------------------------
------------------------
---------------#--------
---------------#--------
------------------------
------------#----------D
------------#-----------
------------#----DDDD---
---------------#--------
D--------------#D-------
D--------------#--------
D-------oo----##--------
X---#---##---###--------
XX--#--y--y--###--------
XXXXXXXXXXXXXXXXXXXXXXXX
XXXXXXXXXXXXXXXXXXXXXXXX