------------------------
------------------------
------------------------
------------------------
-----oo-----------------
------------oX----------
------------oX----------
------------XX----------
-XXX----XX--XX----------
-XXX----XX--XX----------
---X---------X---o------
X--X---------X---o------
X--X---------X---o------
---X---------X-------k--
XXXX---------X-XXXXXXXXX
XXXX---------X-XXXXXXXXX