--------D---------------
--------D---------------
--------D---------------
--------D---------------
--------D---------------
--------D-------------#-
--------D-------------#-
--------D-------------#-
--------D---------------
DDDDDDDDD---------------
------------------------
------------------oo----
--ooo---oo----#---##---#
---y--Y--y-X--#--y--y--#
XXXXXXXXXXXXXXXXXXXXXXXX
XXXXXXXXXXXXXXXXXXXXXXXX