-----------D-D----------
-----------D-D----------
-----------D-D----------
-----------D-D----------
-----------D-D----------
-----------D-D----------
-----------D-D----------
-----------D-D----------
-----------D-D----------
-----------D-D----------
DDDDDDDDDDD--DDDDDDDDDDD
---oo-------------oo----
------------------------
-y----y------k--y----y--
XXXXXXXXXXXXXXXXXXXXXXXX
XXXXXXXXXXXXXXXXXXXXXXXX