------------------------
------------------------
!--!--------------------
------------------------
------------------------
!--!--------------------
------------------------
-----k------------------
XXXXXX------------------
XXXXXX------------------
------------------------
--------------C-S-S-C---
-----------------------D
--------------ooo------D
-------XXXX--XXXXX-XXXXX
-------XXXX--XXXXX-XXXXX