------------------------
------------------------
------------------------
------------------------
------------------------
----------------------D-
-o----------------------
o-o---------------------
-o-o--------------TT----
DDDDDDD-----------tt----
--------------TToott----
--------------ttoott----
T-------------ttoott----
t-------------ttggtt----
t---TT--XXXXXXXXXXXXXXXX
t---tt--XXXXXXXXXXXXXXXX