------------------------
------------------------
------------------------
------------------------
--------------oo--------
---------------------oX-
--------o------------oX-
--------o------------XX-
--------o-XXX----XX--XX-
--------D-XXX----XX--XX-
------------X---------X-
-------*-X--X---------X-
----*--D-X--X---------X-
--g-D--D----X---------X-
XXXXXXXXXXXXX---------X-
XXXXXXXXXXXXX---------X-