-DD---------------------
--D---------------------
--D---------------------
--D---------------------
--D---------------------
--D--------------oo-----
--D---------------------
--D----------D----------
--D--------------DD--oo-
--DDDDDDDDDDDD---D*-----
-----------D---X-D*-----
--o--------D---X-D----g-
--*----------o-X-D---DD-
--D----r-----*-X-D*-----
XXXXXXXXXXXXXXXX-D------
XXXXXXXXXXXXXXXX-D------