------------------------
------------------------
-------#-----------o----
-------#-----G--G-D-D---
---------DDDDDDDDDDoD---
----#----DDDDDDDDDD-D---
----#-------------DoD---
----#---D---------D-D---
-------#----------DoD---
-------#----------D-D---
-------#----------DoD---
oo----##----------D-D---
##---###----------Do----
--y--###----------D-----
XXXXXXXX----------XXXXXX
XXXXXXXX----------XXXXXX