D-----------------------
D-----------------------
D-----------------------
D-----------------------
D-----------------------
D-----------------------
D-----------------------
D--------------D--------
D-----------------------
D-------o----D---------o
--------o--------------o
--------o------D-------o
--------o------D-------o
-D------r------DD------r
XXXX----D----XXXXXX----D
XXXX---------XXXXXX-----