-------D----------------
-------D----------------
-------D----------------
-------D----------------
-------D----------------
-------D-------------#--
-------D-------------#--
-------D-------------#--
-------D----------------
DDDDDDDD----------------
------------------------
-----------------oo----#
-ooo---oo----#---##---##
--y--Y--y-X--#--y--y--##
XXXXXXXXXXXXXXXXXXXXXXXX
XXXXXXXXXXXXXXXXXXXXXXXX