D-----------------------
D-----------------------
D-----------------------
D-----------------------
D-----------------------
D-----------------------
D-----------------------
D-----------------------
D-----------------------
D--------------X--------
-------TT-----XX--------
------otto-----X----DDDD
------otto-----X---D----
-X-X--otto--X-X---D-----
XXXXXXXXXXXXXXXXXXXXXXXX
XXXXXXXXXXXXXXXXXXXXXXXX