------------------------
------------------------
--o---------------------
-D-D--------------------
DDoD--------------------
DD-D--------------------
-DoD--------------------
-D-D----------------o---
-DoD----------------D---
-D-D----------------D---
-DoD----o---------------
-D-D----o----------*----
-Do-----o-------*--D----
-D----------k---D--D---D
-XXXXXXXXXXXXXXXXXXXXXXX
-XXXXXXXXXXXXXXXXXXXXXXX