----D-------------------
----D-------------------
----D-------------------
----D-------------------
----D-------------------
----D--------------D----
----D-------------------
----D-------------------
----D----------TT-------
----D----------tt---XXXX
DDDD-------TToott---XXXX
-----------ttoott-------
-----------ttoott-------
-----------ttggtt-------
XXXXXXXXXXXXXXXXXXXX----
XXXXXXXXXXXXXXXXXXXX----