---------D--------------
---------D--------------
---------D--------------
---------D--------------
---------D--------------
---------D--------------
---------D--------------
---------D--------------
---------DDDDDDDDDDD----
o------------------D----
-o-----------------D--Y-
o-o------------------oo-
-------D-------------oo-
----k--X---XyX-XyXyX-ooD
XXXXXXXXX--XXX-XXXXX-XXX
XXXXXXXXX--XXX-XXXXX-XXX