------------------------
------------------------
------------------------
------------------o-----
-----------------o------
----------------o-------
----------------#-------
---------------##-------
DDDDDDDDD------##-------
-------D----o--##-------
-------*----#--##-------
-----------##--##-------
ooooooo*X--##--##-------
-y--y---X#-##--##----#--
XXXXXXXXXX-XX--XXXXXXXXX
XXXXXXXXXX-XX--XXXXXXXXX