------------------------
------------------------
------------------------
------------------------
------------------------
------------------------
------------------------
------------------------
----------oooo-----g----
-----X##--####--#####XXX
----XX-#-y#--#-y#----XXX
-----X--##----##--------
-----X------------------
--X-X-------------------
XXXXXX------------------
XXXXXX------------------