--D---------D-----------
--D---------D-----------
--D---------D-----------
--D---------D-----------
--D---------D-----------
--D---------D---------o-
--D---------D---------#-
--D---------D--------##-
--D---------D------o-##-
--DDDDDDDDDDD------#-##-
------------------##-##-
-----------------###-##-
------ooo---oo-o-###-##-
-------y--Y--y-#-###-##g
XXXXXXXXXXXXXXXX-XXX-XXX
XXXXXXXXXXXXXXXX-XXX-XXX