------------------------
------------------------
----------------------YY
----------------------DD
------------------------
------------------------
----------------------D-
---------o------------o-
---------D----ooo-----o-
---------D-DD-DDDD-DDDDD
------------------------
--------*---------------
-----*--D---------------
-k---D--D---------------
XXXXXXXXXX--------------
XXXXXXXXXX--------------