-----DD--------D--------
-----DD--------D--------
-----DD--------D--------
-----DD--------D--------
-----DD--------D--------
-----DD--------D--------
-----DD--------D--------
-----DD--------D--------
-----DD--------DDDDDDDDD
XX---DD----XX-----------
XX---DD----XX-----------
D----------D------------
D---------*D--Xooooooooo
D*--oooo--D---X---y--y--
-DDDDDDDDD----XXXXXXXXXX
--------------XXXXXXXXXX