------------------------
------------------------
------------------------
------------------------
------------------------
----oX---------------D--
----oX------------------
----XX------------------
XX--XX-----------TT-----
XX--XX-----------tt---XX
-----X-------TToott---XX
-----X-------ttoott-----
-----X-------ttoott-----
-----X-------ttggtt-----
-----X-XXXXXXXXXXXXXXX--
-----X-XXXXXXXXXXXXXXX--