---D--------------------
---D--------------------
---D--------------------
--oD--------------------
--oD--------------------
-y----------------------
###---------------------
----------------------D-
--#g-g------------------
--######-------o----D---
---------------o--------
---------------o------D-
---------------o------D-
--------D------r------D-
--------XXX----D----XXXX
--------XXX---------XXXX