------------------------
------------------------
-------#----------------
-------#----------------
------------------------
----#-------------------
----#-----------------o-
----#-----------------o-
-------#--------------o-
-------#--------------D-
-------#--o-------------
oo----##--o----------*--
##---###--o-------*--D--
--y--###-----g--g-D--D--
XXXXXXXXXXXXXXXXXXXXXXXX
XXXXXXXXXXXXXXXXXXXXXXXX