---D--------------------
---D--------------------
---D--------------------
---D--------------------
---D--------------------
---D--------------------
---D--------------------
---D--------------o-----
---D--------------D-----
---D--------------D-XX--
DDD---o-------------XX--
------o----------*--D---
------o-------*--D--D---
----------k---D--D--D*--
XXXXXXXXXXXXXXXXXXX--DDD
XXXXXXXXXXXXXXXXXXX-----