------------------------
------------------------
------------------------
------------------------
-------o-*D-------------
-------D--D-------------
----------D-------------
---o------D-------------
---D------D-------------
-o-------*D-------------
-D--------D-------o-----
-----o----D-------o----o
-----D----Do------o----D
---r------Do------g-----
X--X--X---XX------X-----
X--X--X---XX------X-----