------------------------
------------------------
------------------------
------------------------
------------------------
------------------------
------------------------
------------------------
------------------------
-TT---------------------
-TT---------------------
-TT---------------------
-TT------------------K--
-TT-----k---------------
XXXXXXXXXX---XXXXXXXXXX-
XXXXXXXXXX---XXXXXXXXXX-