------------------------
------------------------
------------------------
------------------------
------------------------
------------------------
------------------------
------------------------
------------------------
----o---------------1---
----------------TT------
----------------TT----TT
----------------TT----TT
---------ggg----TT---kTT
XXXXXXXXXXXXXXXXXXXXXXXX
XXXXXXXXXXXXXXXXXXXXXXXX