------------------------
------------------------
------------------------
------------------------
-----g------------------
---DDD----------------o-
-TTDD-----------------o-
-tt----------------o--o-
-tt----X-----------2X-o-
XXXXXX-X------------X-o-
XXXXXX-X-----------oX-o-
-------X-----------2X-o-
-------X------------X---
-------X-r-----r----X---
------XXXX--XX-XX-XXXX--
------XXXX--XX-XX-XXXX--