------------------------
------------------------
------------------------
------------------------
------------------------
------------------------
------------------------
---o--------------------
---D--------------------
---D--------------------
------------------------
--*---2122222222X-------
--D-------ooooooX-------
--D---g--gooooooX--D----
XXXXXXXXXXXXXXXXXXXXXX--
XXXXXXXXXXXXXXXXXXXXXX--