------------------------
------------------------
------------------------
------------------------
------------------------
------------------------
-----SSS----------------
------------------------
-------------oo---------
------------SS----------
--------SS-------%%%%---
-------------------|----
-------------------|----
-------------------|----
X---%----------%%%%|%%%%
X---------------||-||-||