------------------------
------------------------
------------------------
------------------------
------------------------
------------------------
%------S-----SSS--------
------------------------
---------------------oo-
--------------------SS--
-%%%%%----------SS------
%%%||-------------------
-||||-------------------
-||-|-------------------
|||-|XXXX---%----------%
-||-||XXX---------------