------------------------
------------------------
------------------------
------------------------
--------o-%%%-----------
-------%---|------------
-----------|------------
-----------|------------
%-----SS---|---SS-------
-----------|------------
%%%%--------%%%%-----%%%
-||----------||--------|
|||----------||--------|
|||----------||--------|
|||----------||--------|
|||----------||--------|