------------------------
------------------------
------------------------
------------------------
-----------o------------
----------%ooo-------%%%
SS--------S-------%%%||-
-------------------||||-
------------SSSS---||||-
---------o---------||||-
----SS-------------||||-
-------------------||||-
-------%%%%--------||||-
--------||---------||||-
--------||---------||||-
--------||---------||||-