------------------------
------------------------
------------------------
------------------------
------------------------
-----------------------S
%---------SS------------
------------------------
-------------SSS--------
------------------------
%%----------------------
|-----------------------
|---------%%%-----------
|----------|------------
|---%%%%%%-|---------XXX
|----||||-||----------XX