------------------------
------------------------
------------------------
------------------------
------------------------
------------------------
-----------SSS----------
------------------------
------------------------
------------------------
%%%---%%%---------------
-||%%%%|----------------
-||-||||----------------
-||-||||---------------X
%|||||||-----------XXXXX
-||-||||------------XXXX