------------------------
------------------------
------------------------
---oo-------------------
------------------------
----------o-------------
---SS---S------------SSS
-----------------SS-----
------------SSS---------
------------------------
-------%%%%%---------%%%
--------|||-----------||
--------|||-----------||
--------|||-----------||
%%%%%%%-|||-----------||
-|||||--|||-----------||