------------------------
------------------------
------------------------
---------------------o--
oo----------------------
%-----------------------
--------------%%%%%-----
---------------|||------
-----SSS-------||||-----
SS-------------|||------
---------------||-|%%%%-
---------------||-|-|---
---------------||-|-|---
---------------||||-----
----%%--%%%----|||||||XX
-----|---|-----||||-||XX