------------------------
------------------------
------------------------
------------------------
------------------------
------------------------
------------------------
-------------------oo---
-------------S----------
-------------SSS--------
--SS-%%%%%%--------SSSSS
------||||--------------
------||||--------------
------||||--------------
XXXXXX||||-----%%%----%%
XXXXXX||||------|------|