------------------------
------------------------
------------------------
------------------------
------------------------
------------------------
S--------------SS-------
------------------------
----SSS-----------------
----------ooo-----------
--------S-----------SSS-
------------------------
%%%---------------------
||----------------------
||--------------%-------
||----------------------