---------DD-------------
----------D-------------
----------D-------------
----------D-------------
----------D-------------
-o--------D-------------
o-o-------D-------------
-o-o--D---D----------D--
DDDDDDDo--D-------------
-------oD-DDDDDDDDDDDD--
-------oD----------D---X
-------DD-o--------D---X
--------X-*----------o-X
----y---X-D----r-----*-X
XXXXXXXXXXXXXXXXXXXXXXXX
XXXXXXXXXXXXXXXXXXXXXXXX