------------------------
------------------------
%%----------------------
|-----------------------
|-----------------------
|-----------------------
|------oo---------S-----
|---ooooo---------------
|-SSS-------------------
------------------------
--------%%%---%%%-------
---------|%%%%%|--------
--------||||||||--------
--------||||||||--------
%%------|-||||||%%%%%%-%
|-------|-||-|||-||||---