------------------------
------------------------
------------------------
------------------------
------------------------
-------oooo--------oo---
------SS----------------
------------------------
---------SSoo------SSS--
-----------S------------
%----------S--%%%%%-----
-----------S---|||------
---------------|||------
---------------|||------
---%%%%%%------|||-%%%--
----||||-------|||--|---