-----------------------
-----------------------
-----------------------
-----------------------
-----------------------
-----------------------
-----------------------
-----------------------
-----------------------
-----------------oo----
-----------------------
-----------------------
----#------------------
--kk#------------------
XXXXXXXXXXXXXXX------XX
XXXXXXXXXXXXXXX------XX