------------------------
------------------------
------------------------
------------------------
------------------------
------------------------
--------------QQQQ------
-oooo-------------------
------------------------
----------------y-------
------------QQ?SSQQQ----
------------------------
------------------------
------------------------
XXXXXXXXXXXXXXX--XXXXXXX
XXXXXXXXXXXXXXX--XXXXXXX