-----------------------
-----------------------
-----------------------
-----------------------
-----------------------
------------------g----
----------------SSSSSSS
-----------------------
---------------g-------
1----------------------
-------------S@S-------
-----------------------
-----------------------
-----------------------
XXXXX--XXXXXXXXXXXXXXX-
XXXXX--XXXXXXXXXXXXXXX-