-----------------------
-----------------------
-----------------------
-----------------------
-----------------------
-----------------------
Q----------------------
-----------------------
-----------------------
-----------------------
QQQ--------------------
-----------------------
------------TT---------
------------TT---------
XXXXXXXXXXXXXXXXXXXXXXX
XXXXXXXXXXXXXXXXXXXXXXX