-----------------------
-----------------------
-----------------------
SSSSSSSSSSSSSSSSSSSSSSS
-----------------------
-----------------------
-----------------------
-----------------------
-----------------------
---S-------------------
-----------------------
TT---tt-------------#--
TT---tt------------##--
TT--ktt---------kk-##--
XXXXXXXXXXXXXXXXXXXXX--
XXXXXXXXXXXXXXXXXXXXX--