------------------------
------------------------
------------------------
SSSSSSSSSSSS-------SSSS-
------------------------
------------------------
-------------------SUS--
------------------------
---------------SSS------
------------------------
-------TT----------SSSS-
----#--TT--##-----------
---##--TT--##-----------
kk-##--TT--##-----------
XXXXX--XX--XX------XXXX-
XXXXX--XX--XX------XXXX-