------------------------
------------------------
------------------------
SSSSSSSSSSSSSSSSSSSSSSSS
--------SSSSSSSSSSSSSSSS
--------SSSSSSSSSSSSSSSS
--------SSSSSSSSSSSSSSSS
------------------------
------------------------
------------------------
----------SSSSSS?-SSSSSS
----------SSSSS---SSSSSS
----------SSSSS---SSSSSS
---------------oooSSSSSS
-XX--X---XXXXXXXXXXXXXXX
-XX--X---XXXXXXXXXXXXXXX