------------------------
------------------------
------------------------
------------------------
------------------------
------------------------
------------------------
------------------------
------------------------
tt----------------------
tt----------------------
tt----------------------
tt----------------------
tt-----k--ggg-----ggg---
XXXXXXXXXXXXXXXXXXXXXXXX
XXXXXXXXXXXXXXXXXXXXXXXX