------------------------
------------------------
------------------------
------------------------
------------------------
------------------------
------------------------
------------------------
------------------------
---------------oo-------
--------------o--o------
------------------------
------------------------
------------------------
XXXXX--XXXXXXXXXXXXXXXXX
XXXXX--XXXXXXXXXXXXXXXXX