-----------------------
-----------------------
-----------------------
SSSSSSSSSSSSSS---------
-----------------------
-----------------------
----------------SSS----
-----------------------
-----------------------
---------------------SS
-----------g##---------
-----------###---------
---------g####--SSS----
---------#####---------
--XXXXXXXXXXXX-------XX
--XXXXXXXXXXXX-------XX