------------------------
------------------------
------------------------
SSSSSSSSSSSSSSSSSSSSSSSS
------------------------
------------------------
------------------------
------------------------
------------------------
------------------------
---------TT-------------
---TT----TT-----------SS
---TT----TT----TT-----SS
g--TT----TT--g-TT-----SS
XXXXXXXXXXXXXXXXXXXX--XX
XXXXXXXXXXXXXXXXXXXX--XX