--D---------------------
--D---------------------
--D---------------------
--D---------------------
--D---------------------
--D--------------------o
D-D------o-------------#
--D-----o-o-----------##
D-D----o-o-o--------o-##
--DDDDDDDDDDDDD-----#-##
D------------------##-##
------------------###-##
-------TT-------o-###-##
-------tt-------#-###-##
---TT--tt---TT--X-XXX-XX
-X-tt--tt---tt--X-XXX-XX