------------------------
------------------------
------------------------
------------------------
------------------------
------------------------
---------D--------------
--------YD--------------
--------DD--------------
---------D--------------
---g-g-g-D--------------
DDDDDDDDDD--2122222222X-
---------D------ooooooX-
---------D--g--gooooooX-
XXXXXXXXXXXXXXXXXXXXXXXX
XXXXXXXXXXXXXXXXXXXXXXXX