-------D----------------
-------D----------------
-------D----------------
-------D----------------
-------D----------------
-------D----------------
-----D-D----------------
----YD-D----------------
----DD-DDDDDDDDDDD------
-----D-----------D------
-g-g-D-----------D--Y---
DDDDDD-------------oo---
-----D-------------oo---
-----D---XyX-XyXyX-oo---
XXXXXXX--XXX-XXXXX-XXX--
XXXXXXX--XXX-XXXXX-XXX--